,occ_hu,own_occ,own_hh1,own_hh2,own_hh3,own_hh4,own_hh5,own_hh6,own_hh7,rent_occ,ren_hh1,ren_hh2,ren_hh3,ren_hh4,ren_hh5,ren_hh6,ren_hh7,occ_hu2,own_mort,own_clear,rent_occ2,tot_pop,NAME,state,county,tract,cty_name
1,1191,135,48,38,11,13,12,5,8,1056,270,210,192,176,119,40,49,1191,103,32,1056,3732,Census Tract 78.01,08,001,007801,Adams County
2,1240,157,33,36,23,15,23,12,15,1083,300,246,182,131,117,60,47,1240,123,34,1083,3758,Census Tract 78.02,08,001,007802,Adams County
3,1780,535,142,137,77,62,52,29,36,1245,297,286,198,191,124,65,84,1780,430,105,1245,5555,Census Tract 79,08,001,007900,Adams County
4,1726,993,228,295,135,113,89,59,74,733,158,142,84,112,88,68,81,1726,765,228,733,5742,Census Tract 80,08,001,008000,Adams County
5,314,36,9,11,2,2,7,4,1,278,131,110,21,5,7,3,1,314,20,16,278,854,Census Tract 81,08,001,008100,Adams County
6,1477,1111,245,362,144,108,85,69,98,366,49,52,47,64,53,40,61,1477,769,342,366,5484,Census Tract 82,08,001,008200,Adams County
7,1802,925,241,269,137,105,78,42,53,877,189,187,140,140,101,58,62,1802,555,370,877,5557,Census Tract 83.08,08,001,008308,Adams County
8,1030,713,154,184,93,108,88,58,28,317,62,64,62,63,38,17,11,1030,440,273,317,3254,Census Tract 83.09,08,001,008309,Adams County
9,2137,1697,424,487,289,260,130,61,46,440,89,112,84,71,44,19,21,2137,1585,112,440,6044,Census Tract 83.53,08,001,008353,Adams County
10,1543,1238,218,437,237,179,90,52,25,305,93,72,45,41,33,16,5,1543,1030,208,305,4315,Census Tract 84.01,08,001,008401,Adams County
11,1574,1278,212,454,227,224,98,35,28,296,104,76,43,38,22,11,2,1574,1060,218,296,4352,Census Tract 84.02,08,001,008402,Adams County
12,2376,1921,391,676,344,273,114,64,59,455,137,93,57,65,52,29,22,2376,1428,493,455,6655,Census Tract 85.05,08,001,008505,Adams County
13,2425,491,121,162,87,64,33,13,11,1934,940,442,251,171,89,26,15,2425,444,47,1934,5383,Census Tract 85.06,08,001,008506,Adams County
14,2036,1711,296,617,317,227,124,75,55,325,35,55,67,63,55,22,28,2036,1294,417,325,6099,Census Tract 85.07,08,001,008507,Adams County
15,1893,1354,216,457,251,236,115,41,38,539,161,166,80,68,35,13,16,1893,1161,193,539,5342,Census Tract 85.08,08,001,008508,Adams County
16,2610,2221,294,873,386,381,176,73,38,389,65,91,78,69,45,29,12,2610,1915,306,389,7586,Census Tract 85.23,08,001,008523,Adams County
17,2462,2253,252,639,454,567,212,71,58,209,21,43,45,48,29,14,9,2462,2115,138,209,7814,Census Tract 85.24,08,001,008524,Adams County
18,2410,1975,326,622,372,409,169,51,26,435,130,136,76,53,26,12,2,2410,1736,239,435,6742,Census Tract 85.26,08,001,008526,Adams County
19,3308,1251,295,492,223,144,59,25,13,2057,744,715,325,182,59,20,12,3308,1042,209,2057,7446,Census Tract 85.29,08,001,008529,Adams County
20,2976,1378,244,391,267,270,122,55,29,1598,644,482,226,153,53,25,15,2976,1334,44,1598,7650,Census Tract 85.33,08,001,008533,Adams County
21,1399,1231,162,436,226,223,104,52,28,168,7,35,35,44,26,11,10,1399,1101,130,168,4283,Census Tract 85.34,08,001,008534,Adams County
22,1111,766,117,247,136,140,84,25,17,345,79,77,64,71,34,13,7,1111,689,77,345,3298,Census Tract 85.35,08,001,008535,Adams County
23,832,750,111,258,143,129,74,24,11,82,11,17,23,14,8,7,2,832,710,40,82,2443,Census Tract 85.36,08,001,008536,Adams County
24,1858,1686,196,493,293,388,178,84,54,172,17,32,29,41,37,11,5,1858,1595,91,172,6047,Census Tract 85.37,08,001,008537,Adams County
25,1773,1588,207,545,321,314,130,51,20,185,14,36,27,60,30,10,8,1773,1527,61,185,5305,Census Tract 85.38,08,001,008538,Adams County
26,2660,2286,337,640,454,444,236,96,79,374,30,84,66,93,67,21,13,2660,2236,50,374,8437,Census Tract 85.39,08,001,008539,Adams County
27,2087,1950,209,635,385,459,155,75,32,137,12,38,25,29,21,7,5,2087,1866,84,137,6408,Census Tract 85.40,08,001,008540,Adams County
28,1500,1443,128,663,250,243,102,28,29,57,7,15,9,14,3,3,6,1500,1271,172,57,4277,Census Tract 85.41,08,001,008541,Adams County
29,2227,1954,248,563,370,442,212,83,36,273,25,49,66,74,34,17,8,2227,1883,71,273,7036,Census Tract 85.42,08,001,008542,Adams County
30,2361,1836,352,563,310,331,147,85,48,525,223,66,68,75,59,18,16,2361,1389,447,525,6935,Census Tract 85.43,08,001,008543,Adams County
31,1334,1231,145,351,250,299,123,46,17,103,10,17,21,33,12,6,4,1334,1190,41,103,4181,Census Tract 85.44,08,001,008544,Adams County
32,2165,1994,207,651,387,447,188,80,34,171,14,34,42,37,24,7,13,2165,1771,223,171,6769,Census Tract 85.45,08,001,008545,Adams County
33,1041,851,189,255,163,155,57,18,14,190,31,41,39,39,25,13,2,1041,815,36,190,2912,Census Tract 85.46,08,001,008546,Adams County
34,1164,784,102,256,177,153,55,25,16,380,106,69,85,78,31,8,3,1164,726,58,380,3525,Census Tract 85.47,08,001,008547,Adams County
35,528,436,72,152,89,73,30,10,10,92,12,27,19,20,10,3,1,528,420,16,92,1499,Census Tract 85.48,08,001,008548,Adams County
36,1273,1064,156,313,207,225,111,35,17,209,28,41,45,44,27,16,8,1273,1009,55,209,3906,Census Tract 85.49,08,001,008549,Adams County
37,2662,2330,334,758,471,450,182,78,57,332,41,86,61,66,45,18,15,2662,2130,200,332,7987,Census Tract 85.50,08,001,008550,Adams County
38,183,167,10,62,37,34,15,6,3,16,4,2,2,1,5,1,1,183,140,27,16,571,Census Tract 85.51,08,001,008551,Adams County
39,713,330,84,112,44,46,22,12,10,383,104,60,75,60,47,19,18,713,259,71,383,2055,Census Tract 86.03,08,001,008603,Adams County
40,1163,795,141,254,146,103,76,38,37,368,84,61,66,66,52,24,15,1163,656,139,368,4923,Census Tract 86.04,08,001,008604,Adams County
41,1310,914,161,376,142,124,56,31,24,396,100,78,70,63,56,19,10,1310,674,240,396,3679,Census Tract 86.05,08,001,008605,Adams County
42,2143,1063,252,336,167,138,78,38,54,1080,353,230,172,173,91,41,20,2143,839,224,1080,5931,Census Tract 86.06,08,001,008606,Adams County
43,1528,908,216,266,124,125,83,48,46,620,120,122,94,100,92,53,39,1528,617,291,620,4921,Census Tract 87.05,08,001,008705,Adams County
44,1598,813,182,236,130,115,64,31,55,785,123,143,125,142,115,76,61,1598,595,218,785,5436,Census Tract 87.06,08,001,008706,Adams County
45,2448,986,191,274,146,134,87,65,89,1462,420,292,242,221,151,81,55,2448,772,214,1462,7656,Census Tract 87.09,08,001,008709,Adams County
46,1394,873,169,253,137,122,73,53,66,521,67,97,78,115,78,51,35,1394,656,217,521,4752,Census Tract 88.01,08,001,008801,Adams County
47,1143,721,142,204,103,102,82,49,39,422,71,77,61,76,61,44,32,1143,425,296,422,4075,Census Tract 88.02,08,001,008802,Adams County
48,711,444,115,129,63,46,41,26,24,267,61,35,41,52,28,24,26,711,339,105,267,2316,Census Tract 89.01,08,001,008901,Adams County
49,1460,934,174,307,145,128,86,44,50,526,80,107,117,85,68,37,32,1460,722,212,526,4645,Census Tract 90.01,08,001,009001,Adams County
50,3102,1965,444,606,348,271,142,80,74,1137,205,244,250,199,137,60,42,3102,1705,260,1137,9203,Census Tract 90.02,08,001,009002,Adams County
51,1334,1050,226,315,170,149,114,42,34,284,32,46,61,61,47,22,15,1334,826,224,284,4112,Census Tract 91.01,08,001,009101,Adams County
52,1054,876,149,208,154,174,108,49,34,178,28,29,30,40,25,12,14,1054,583,293,178,3462,Census Tract 91.03,08,001,009103,Adams County
53,1738,1261,234,349,214,198,138,81,47,477,124,125,90,80,36,13,9,1738,1107,154,477,5200,Census Tract 91.04,08,001,009104,Adams County
54,1366,930,207,281,154,147,76,40,25,436,53,72,78,101,71,30,31,1366,755,175,436,4242,Census Tract 92.02,08,001,009202,Adams County
55,1596,89,17,39,11,8,8,3,3,1507,474,379,262,201,127,38,26,1596,70,19,1507,4222,Census Tract 92.03,08,001,009203,Adams County
56,2445,1303,216,389,236,232,132,60,38,1142,402,378,171,111,60,12,8,2445,1208,95,1142,6500,Census Tract 92.04,08,001,009204,Adams County
57,747,628,176,181,83,96,48,25,19,119,27,43,20,17,5,3,4,747,542,86,119,2021,Census Tract 92.06,08,001,009206,Adams County
58,1516,812,120,283,157,121,64,36,31,704,173,164,148,121,56,22,20,1516,728,84,704,4429,Census Tract 92.07,08,001,009207,Adams County
59,2046,1308,351,463,217,141,75,34,27,738,166,194,144,125,62,29,18,2046,991,317,738,5400,Census Tract 93.04,08,001,009304,Adams County
60,1186,969,165,367,153,123,67,39,55,217,27,38,43,38,28,22,21,1186,709,260,217,3692,Census Tract 93.06,08,001,009306,Adams County
61,1214,672,107,223,122,81,57,41,41,542,137,106,90,90,63,34,22,1214,502,170,542,3774,Census Tract 93.07,08,001,009307,Adams County
62,1328,789,137,246,143,113,76,37,37,539,114,134,89,87,63,30,22,1328,634,155,539,4087,Census Tract 93.08,08,001,009308,Adams County
63,1413,752,179,255,137,96,45,22,18,661,265,139,95,76,51,20,15,1413,640,112,661,3613,Census Tract 93.09,08,001,009309,Adams County
64,1857,1077,223,329,173,147,92,46,67,780,183,152,124,127,99,47,48,1857,797,280,780,5827,Census Tract 93.10,08,001,009310,Adams County
65,2011,1572,434,498,195,170,147,68,60,439,87,95,63,70,66,37,21,2011,755,817,439,5751,Census Tract 93.16,08,001,009316,Adams County
66,2038,816,265,229,105,95,67,31,24,1222,311,276,208,214,132,52,29,2038,617,199,1222,5664,Census Tract 93.18,08,001,009318,Adams County
67,905,529,143,144,90,74,41,23,14,376,76,84,84,68,35,13,16,905,318,211,376,2605,Census Tract 93.19,08,001,009319,Adams County
68,1175,482,189,146,53,53,24,10,7,693,256,184,126,75,33,14,5,1175,305,177,693,2672,Census Tract 93.20,08,001,009320,Adams County
69,1528,812,225,238,127,105,60,34,23,716,258,223,114,72,35,8,6,1528,446,366,716,3782,Census Tract 93.21,08,001,009321,Adams County
70,1525,1087,287,327,168,125,105,41,34,438,115,93,77,77,47,21,8,1525,766,321,438,4246,Census Tract 93.22,08,001,009322,Adams County
71,1455,516,90,186,98,73,43,11,15,939,324,250,167,103,59,22,14,1455,428,88,939,3728,Census Tract 93.23,08,001,009323,Adams County
72,2387,1320,362,592,174,134,47,5,6,1067,431,366,156,74,24,13,3,2387,1068,252,1067,5063,Census Tract 93.25,08,001,009325,Adams County
73,1076,767,139,332,113,111,49,18,5,309,147,101,36,18,6,1,0,1076,636,131,309,2554,Census Tract 93.26,08,001,009326,Adams County
74,1544,1185,218,507,184,150,63,37,26,359,93,88,62,61,38,13,4,1544,874,311,359,4124,Census Tract 93.27,08,001,009327,Adams County
75,1743,1319,314,429,245,155,89,40,47,424,95,95,74,68,51,25,16,1743,979,340,424,4903,Census Tract 94.01,08,001,009401,Adams County
76,1700,1087,229,411,174,145,75,24,29,613,215,228,83,40,22,12,13,1700,780,307,613,4259,Census Tract 94.06,08,001,009406,Adams County
77,1746,1052,219,387,174,126,64,41,41,694,113,155,124,142,81,38,41,1746,825,227,694,5227,Census Tract 94.07,08,001,009407,Adams County
78,1682,1263,236,459,228,241,68,19,12,419,135,165,68,30,16,3,2,1682,1099,164,419,4260,Census Tract 94.08,08,001,009408,Adams County
79,2119,1681,337,682,276,245,92,34,15,438,153,158,58,45,12,7,5,2119,1397,284,438,5248,Census Tract 94.09,08,001,009409,Adams County
80,1261,1143,137,529,213,158,73,22,11,118,60,21,13,4,13,1,6,1261,863,280,118,3316,Census Tract 94.10,08,001,009410,Adams County
81,1222,825,232,335,120,102,22,8,6,397,71,140,87,57,27,5,10,1222,652,173,397,2959,Census Tract 94.11,08,001,009411,Adams County
82,1094,628,127,209,89,94,48,30,31,466,146,114,72,53,45,20,16,1094,474,154,466,3156,Census Tract 95.01,08,001,009501,Adams County
83,1187,867,207,259,130,110,70,46,45,320,62,69,53,44,47,23,22,1187,581,286,320,3633,Census Tract 95.02,08,001,009502,Adams County
84,1024,596,114,229,95,63,40,25,30,428,126,89,62,75,36,21,19,1024,435,161,428,2959,Census Tract 95.53,08,001,009553,Adams County
85,2311,1026,264,355,172,111,66,31,27,1285,447,320,230,158,84,29,17,2311,820,206,1285,5921,Census Tract 96.03,08,001,009603,Adams County
86,1959,900,273,319,142,81,42,21,22,1059,504,230,130,96,60,30,9,1959,689,211,1059,4569,Census Tract 96.04,08,001,009604,Adams County
87,1021,380,97,121,62,47,27,12,14,641,192,152,98,97,56,28,18,1021,274,106,641,2794,Census Tract 96.06,08,001,009606,Adams County
88,1806,792,143,285,115,112,79,35,23,1014,366,240,151,124,80,35,18,1806,621,171,1014,4931,Census Tract 96.07,08,001,009607,Adams County
89,1108,948,266,310,166,109,53,28,16,160,34,42,32,27,16,6,3,1108,767,181,160,2849,Census Tract 96.08,08,001,009608,Adams County
90,1341,745,210,219,103,92,73,31,17,596,191,147,91,71,58,19,19,1341,387,358,596,3626,Census Tract 97.51,08,001,009751,Adams County
91,1021,657,150,213,102,91,59,20,22,364,69,71,74,59,37,34,20,1021,517,140,364,3061,Census Tract 97.52,08,001,009752,Adams County
92,1051,751,265,274,66,74,39,13,20,300,98,87,42,31,25,13,4,1051,369,382,300,2495,Census Tract 150,08,001,015000,Adams County
93,1480,1397,110,431,267,359,156,57,17,83,9,20,14,19,12,6,3,1480,1232,165,83,4747,Census Tract 600,08,001,060000,Adams County
94,2084,1895,313,565,361,382,192,47,35,189,23,46,46,38,17,15,4,2084,1644,251,189,6170,Census Tract 601,08,001,060100,Adams County
95,1748,688,239,211,105,97,24,8,4,1060,416,384,155,71,20,11,3,1748,616,72,1060,3681,Census Tract 602,08,001,060200,Adams County
96,391,333,40,96,59,79,36,12,11,58,10,3,8,14,16,5,2,391,304,29,58,1294,Census Tract 612,08,001,061200,Adams County
97,0,0,0,0,0,0,0,0,0,0,0,0,0,0,0,0,0,0,0,0,0,0,Census Tract 9887,08,001,988700,Adams County
1,733,585,151,235,90,53,36,12,8,148,48,50,18,14,7,9,2,733,321,264,148,1775,Census Tract 9600,08,003,960000,Alamosa County
2,960,791,142,314,134,102,53,33,13,169,61,51,21,18,15,1,2,960,515,276,169,2532,Census Tract 9601,08,003,960100,Alamosa County
3,2608,1309,314,536,183,153,75,31,17,1299,607,333,181,106,43,20,9,2608,884,425,1299,6342,Census Tract 9602,08,003,960200,Alamosa County
4,1694,962,244,284,166,120,82,37,29,732,245,182,123,91,48,29,14,1694,610,352,732,4796,Census Tract 9603,08,003,960300,Alamosa County
1,1069,187,122,48,15,2,0,0,0,882,479,232,87,41,27,8,8,1069,169,18,882,1883,Census Tract 49.51,08,005,004951,Arapahoe County
2,1301,37,18,17,1,1,0,0,0,1264,679,376,100,59,31,15,4,1301,35,2,1264,2301,Census Tract 49.52,08,005,004952,Arapahoe County
3,1064,486,128,153,80,58,31,13,23,578,122,134,111,105,59,22,25,1064,396,90,578,3224,Census Tract 55.51,08,005,005551,Arapahoe County
4,1022,602,238,232,61,31,21,13,6,420,138,87,63,57,37,22,16,1022,311,291,420,2414,Census Tract 55.52,08,005,005552,Arapahoe County
5,1415,803,184,271,150,105,51,22,20,612,211,172,107,63,38,16,5,1415,609,194,612,3594,Census Tract 55.53,08,005,005553,Arapahoe County
6,1896,1571,341,644,254,208,77,35,12,325,138,63,39,45,24,8,8,1896,1073,498,325,4747,Census Tract 56.11,08,005,005611,Arapahoe County
7,1445,879,147,356,154,134,59,20,9,566,218,163,86,52,32,11,4,1445,617,262,566,3616,Census Tract 56.12,08,005,005612,Arapahoe County
8,1269,1114,270,442,182,156,43,15,6,155,26,48,23,28,14,11,5,1269,808,306,155,3146,Census Tract 56.14,08,005,005614,Arapahoe County
9,1748,1460,315,554,253,215,79,36,8,288,68,73,54,39,33,15,6,1748,1041,419,288,4574,Census Tract 56.19,08,005,005619,Arapahoe County
10,1627,749,480,217,36,11,4,1,0,878,501,260,64,38,10,3,2,1627,554,195,878,2539,Census Tract 56.20,08,005,005620,Arapahoe County
11,1147,997,157,418,158,178,67,15,4,150,94,27,15,7,4,1,2,1147,730,267,150,2899,Census Tract 56.21,08,005,005621,Arapahoe County
12,921,692,67,322,121,107,55,16,4,229,95,92,26,13,2,1,0,921,463,229,229,2326,Census Tract 56.22,08,005,005622,Arapahoe County
13,1405,1292,251,556,203,181,74,15,12,113,28,31,32,10,6,5,1,1405,906,386,113,3547,Census Tract 56.23,08,005,005623,Arapahoe County
14,797,751,113,339,129,115,34,17,4,46,8,11,8,8,5,2,4,797,524,227,46,2106,Census Tract 56.24,08,005,005624,Arapahoe County
15,1188,948,246,362,169,107,35,21,8,240,82,65,29,30,20,10,4,1188,714,234,240,2899,Census Tract 56.25,08,005,005625,Arapahoe County
16,1392,1124,345,394,165,141,54,18,7,268,111,75,36,30,10,5,1,1392,826,298,268,3210,Census Tract 56.26,08,005,005626,Arapahoe County
17,1763,1606,396,648,254,217,61,19,11,157,30,46,37,28,7,7,2,1763,1111,495,157,4271,Census Tract 56.27,08,005,005627,Arapahoe County
18,2197,1698,367,646,283,248,107,37,10,499,212,111,61,56,33,17,9,2197,1346,352,499,5609,Census Tract 56.28,08,005,005628,Arapahoe County
19,798,779,92,332,124,155,58,16,2,19,5,2,4,3,1,2,2,798,587,192,19,2215,Census Tract 56.29,08,005,005629,Arapahoe County
20,2158,1880,442,719,313,269,101,20,16,278,82,87,58,36,12,2,1,2158,1493,387,278,5322,Census Tract 56.30,08,005,005630,Arapahoe County
21,1194,1108,240,445,195,132,66,22,8,86,16,27,12,16,6,7,2,1194,831,277,86,3028,Census Tract 56.31,08,005,005631,Arapahoe County
22,1155,950,113,369,191,195,49,25,8,205,51,61,49,24,12,6,2,1155,789,161,205,3189,Census Tract 56.32,08,005,005632,Arapahoe County
23,1251,970,195,381,161,153,68,6,6,281,146,75,24,28,5,0,3,1251,767,203,281,3002,Census Tract 56.33,08,005,005633,Arapahoe County
24,1587,1323,638,488,106,66,15,8,2,264,117,85,41,13,5,2,1,1587,863,460,264,2959,Census Tract 56.34,08,005,005634,Arapahoe County
25,1983,1602,386,671,230,203,79,21,12,381,192,100,35,28,18,6,2,1983,1203,399,381,4789,Census Tract 56.35,08,005,005635,Arapahoe County
26,653,629,51,317,80,99,57,22,3,24,8,7,2,3,2,1,1,653,399,230,24,1825,Census Tract 56.36,08,005,005636,Arapahoe County
27,1736,598,195,221,86,45,35,12,4,1138,491,392,144,61,31,13,6,1736,439,159,1138,3593,Census Tract 57,08,005,005700,Arapahoe County
28,1186,879,312,374,121,54,14,4,0,307,112,107,44,28,12,2,2,1186,693,186,307,2391,Census Tract 58,08,005,005800,Arapahoe County
29,2285,624,239,225,85,57,11,5,2,1661,1099,361,114,58,23,2,4,2285,487,137,1661,4032,Census Tract 59.51,08,005,005951,Arapahoe County
30,1569,540,203,197,62,59,17,2,0,1029,457,354,131,55,22,9,1,1569,352,188,1029,3091,Census Tract 59.52,08,005,005952,Arapahoe County
31,1309,621,196,243,87,56,23,11,5,688,353,184,88,32,13,9,9,1309,490,131,688,2693,Census Tract 60,08,005,006000,Arapahoe County
32,1294,625,211,236,97,58,17,2,4,669,330,189,72,47,17,12,2,1294,518,107,669,2672,Census Tract 61,08,005,006100,Arapahoe County
33,1243,878,259,352,141,64,41,15,6,365,118,118,65,25,24,8,7,1243,678,200,365,2864,Census Tract 62,08,005,006200,Arapahoe County
34,1158,870,296,333,120,80,26,6,9,288,75,99,47,29,22,9,7,1158,670,200,288,2621,Census Tract 63,08,005,006300,Arapahoe County
35,1191,663,164,271,110,72,33,6,7,528,192,141,79,71,28,10,7,1191,472,191,528,2975,Census Tract 64,08,005,006400,Arapahoe County
36,995,58,27,25,2,3,0,1,0,937,540,248,84,49,9,2,5,995,52,6,937,1678,Census Tract 65.01,08,005,006501,Arapahoe County
37,1417,802,233,324,128,77,26,6,8,615,226,194,103,46,30,10,6,1417,615,187,615,3171,Census Tract 65.02,08,005,006502,Arapahoe County
38,2400,622,252,201,90,46,22,6,5,1778,706,453,251,193,109,38,28,2400,514,108,1778,5610,Census Tract 66.01,08,005,006601,Arapahoe County
39,1342,950,205,391,165,127,39,13,10,392,198,70,39,45,24,6,10,1342,689,261,392,3210,Census Tract 66.03,08,005,006603,Arapahoe County
40,1819,747,168,307,132,93,22,14,11,1072,657,204,87,65,37,15,7,1819,524,223,1072,3761,Census Tract 66.04,08,005,006604,Arapahoe County
41,1451,1394,138,551,224,299,139,35,8,57,18,11,5,11,8,2,2,1451,945,449,57,4239,Census Tract 67.04,08,005,006704,Arapahoe County
42,566,530,49,211,78,88,63,30,11,36,8,6,7,8,3,3,1,566,332,198,36,1748,Census Tract 67.05,08,005,006705,Arapahoe County
43,1992,1532,400,580,205,237,90,18,2,460,144,166,85,45,11,5,4,1992,1148,384,460,4720,Census Tract 67.06,08,005,006706,Arapahoe County
44,1804,1509,348,563,260,222,92,22,2,295,95,71,57,32,26,10,4,1804,1182,327,295,4530,Census Tract 67.07,08,005,006707,Arapahoe County
45,1930,1561,281,595,265,293,99,22,6,369,99,135,69,44,19,2,1,1930,1220,341,369,4979,Census Tract 67.08,08,005,006708,Arapahoe County
46,1971,1763,398,654,317,283,95,10,6,208,59,67,34,33,10,3,2,1971,1420,343,208,4882,Census Tract 67.09,08,005,006709,Arapahoe County
47,1421,1332,203,512,261,243,85,21,7,89,19,18,17,21,7,4,3,1421,1015,317,89,3869,Census Tract 67.11,08,005,006711,Arapahoe County
48,454,411,60,169,67,60,47,5,3,43,15,19,1,5,3,0,0,454,291,120,43,1219,Census Tract 67.12,08,005,006712,Arapahoe County
49,713,5,2,3,0,0,0,0,0,708,379,210,82,32,3,1,1,713,4,1,708,1209,Census Tract 67.13,08,005,006713,Arapahoe County
50,1799,1708,134,573,368,443,149,28,13,91,11,18,28,21,7,4,2,1799,1333,375,91,5475,Census Tract 68.08,08,005,006808,Arapahoe County
51,1712,837,188,312,148,137,39,9,4,875,351,255,116,78,43,13,19,1712,689,148,875,4057,Census Tract 68.15,08,005,006815,Arapahoe County
52,1054,529,119,197,80,87,35,8,3,525,248,150,59,47,9,8,4,1054,407,122,525,2383,Census Tract 68.54,08,005,006854,Arapahoe County
53,1856,1547,198,556,307,347,100,29,10,309,98,101,53,31,21,1,4,1856,1308,239,309,5097,Census Tract 68.55,08,005,006855,Arapahoe County
54,2975,1186,412,379,210,129,42,13,1,1789,692,575,270,154,68,25,5,2975,1142,44,1789,7648,Census Tract 68.56,08,005,006856,Arapahoe County
55,844,765,130,297,132,141,57,5,3,79,50,13,7,5,3,1,0,844,578,187,79,2158,Census Tract 68.57,08,005,006857,Arapahoe County
56,2414,476,256,142,48,22,5,2,1,1938,1106,570,160,71,23,6,2,2414,423,53,1938,4143,Census Tract 68.58,08,005,006858,Arapahoe County
57,1874,1505,254,611,233,233,96,50,28,369,126,81,63,45,22,18,14,1874,1167,338,369,5107,Census Tract 71.01,08,005,007101,Arapahoe County
58,548,527,70,213,100,76,35,19,14,21,5,2,5,3,2,3,1,548,434,93,21,1585,Census Tract 71.03,08,005,007103,Arapahoe County
59,1458,1021,133,354,214,203,73,26,18,437,38,91,123,100,59,17,9,1458,968,53,437,4958,Census Tract 71.04,08,005,007104,Arapahoe County
60,1123,983,171,373,174,156,66,32,11,140,23,39,25,25,17,7,4,1123,850,133,140,3103,Census Tract 71.05,08,005,007105,Arapahoe County
61,1389,1266,142,384,261,307,101,43,28,123,22,29,23,20,19,8,2,1389,1200,66,123,4294,Census Tract 71.06,08,005,007106,Arapahoe County
62,1444,1085,72,269,230,331,125,33,25,359,134,108,47,47,16,6,1,1444,1046,39,359,4430,Census Tract 71.07,08,005,007107,Arapahoe County
63,1214,460,100,144,60,50,55,28,23,754,270,179,104,84,60,22,35,1214,354,106,754,3589,Census Tract 72.01,08,005,007201,Arapahoe County
64,1259,509,149,133,75,54,45,25,28,750,159,134,130,155,78,55,39,1259,415,94,750,3915,Census Tract 72.02,08,005,007202,Arapahoe County
65,956,229,63,68,28,25,19,11,15,727,243,189,112,91,48,24,20,956,161,68,727,2548,Census Tract 73.01,08,005,007301,Arapahoe County
66,1735,278,90,67,39,26,16,17,23,1457,515,266,209,194,147,70,56,1735,229,49,1457,4927,Census Tract 73.02,08,005,007302,Arapahoe County
67,1546,936,266,271,128,97,69,53,52,610,84,126,95,95,88,52,70,1546,768,168,610,4992,Census Tract 74,08,005,007400,Arapahoe County
68,764,517,134,173,80,55,43,19,13,247,17,36,34,45,51,37,27,764,385,132,247,2458,Census Tract 75,08,005,007500,Arapahoe County
69,1212,512,129,173,66,51,46,21,26,700,272,148,90,77,60,29,24,1212,407,105,700,3256,Census Tract 76,08,005,007600,Arapahoe County
70,1525,847,220,321,108,77,52,22,47,678,200,149,124,98,55,31,21,1525,624,223,678,4168,Census Tract 77.02,08,005,007702,Arapahoe County
71,1585,721,180,260,97,79,38,28,39,864,365,199,102,88,56,25,29,1585,492,229,864,4075,Census Tract 77.03,08,005,007703,Arapahoe County
72,1902,761,357,223,82,55,29,8,7,1141,308,255,184,200,114,39,41,1902,630,131,1141,4797,Census Tract 77.04,08,005,007704,Arapahoe County
73,1017,926,246,357,161,116,30,14,2,91,11,22,20,19,11,3,5,1017,659,267,91,2521,Census Tract 151,08,005,015100,Arapahoe County
74,1270,654,137,226,101,94,40,27,29,616,215,141,101,71,56,21,11,1270,499,155,616,3437,Census Tract 800,08,005,080000,Arapahoe County
75,1842,828,241,274,138,83,47,25,20,1014,520,198,114,89,51,26,16,1842,699,129,1014,4277,Census Tract 801,08,005,080100,Arapahoe County
76,1917,1333,224,564,220,188,73,41,23,584,205,150,72,74,43,23,17,1917,984,349,584,5086,Census Tract 802,08,005,080200,Arapahoe County
77,2296,1589,372,611,278,194,81,32,21,707,245,189,115,92,34,18,14,2296,1248,341,707,5701,Census Tract 803,08,005,080300,Arapahoe County
78,1965,1614,541,613,211,170,50,19,10,351,81,96,65,58,36,8,7,1965,1334,280,351,4500,Census Tract 804,08,005,080400,Arapahoe County
79,1550,1105,475,457,79,63,18,10,3,445,152,147,64,54,19,6,3,1550,887,218,445,3059,Census Tract 805,08,005,080500,Arapahoe County
80,1875,763,469,221,53,17,2,1,0,1112,411,309,172,131,53,17,19,1875,657,106,1112,3730,Census Tract 806,08,005,080600,Arapahoe County
81,1873,1117,297,399,163,127,70,32,29,756,165,140,128,139,102,46,36,1873,910,207,756,5545,Census Tract 807,08,005,080700,Arapahoe County
82,849,507,153,176,66,50,28,23,11,342,45,56,48,59,54,39,41,849,418,89,342,2661,Census Tract 808,08,005,080800,Arapahoe County
83,1322,1057,242,370,176,114,60,38,57,265,36,48,48,48,37,20,28,1322,765,292,265,3977,Census Tract 809,08,005,080900,Arapahoe County
84,2371,765,356,234,87,61,13,8,6,1606,549,420,261,198,112,46,20,2371,677,88,1606,5450,Census Tract 810,08,005,081000,Arapahoe County
85,2487,656,279,203,89,51,19,8,7,1831,743,504,291,165,76,36,16,2487,569,87,1831,5376,Census Tract 811,08,005,081100,Arapahoe County
86,1858,962,372,326,121,69,52,13,9,896,251,238,174,123,62,25,23,1858,835,127,896,4462,Census Tract 812,08,005,081200,Arapahoe County
87,1049,670,137,220,106,103,55,27,22,379,84,89,69,49,47,21,20,1049,567,103,379,3119,Census Tract 813,08,005,081300,Arapahoe County
88,1521,1188,252,461,177,140,84,36,38,333,161,68,29,32,18,11,14,1521,952,236,333,4171,Census Tract 814,08,005,081400,Arapahoe County
89,2199,1836,1151,652,30,3,0,0,0,363,254,100,8,1,0,0,0,2199,674,1162,363,3039,Census Tract 815,08,005,081500,Arapahoe County
90,1807,1311,284,493,230,169,72,30,33,496,216,93,56,56,38,21,16,1807,1093,218,496,4859,Census Tract 816,08,005,081600,Arapahoe County
91,939,892,79,342,200,170,64,23,14,47,2,8,13,13,9,1,1,939,753,139,47,2782,Census Tract 817,08,005,081700,Arapahoe County
92,1552,802,174,230,117,98,73,55,55,750,109,127,147,134,92,72,69,1552,561,241,750,5421,Census Tract 818,08,005,081800,Arapahoe County
93,2309,1075,220,397,156,136,87,37,42,1234,431,274,188,146,102,53,40,2309,816,259,1234,6332,Census Tract 819,08,005,081900,Arapahoe County
94,1775,319,171,92,28,13,12,3,0,1456,560,404,244,154,72,12,10,1775,282,37,1456,3797,Census Tract 820,08,005,082000,Arapahoe County
95,2405,965,157,324,177,137,85,44,41,1440,440,340,258,184,135,55,28,2405,853,112,1440,6750,Census Tract 821,08,005,082100,Arapahoe County
96,2157,1415,344,516,227,177,86,38,27,742,202,193,150,105,52,21,19,2157,1243,172,742,5627,Census Tract 822,08,005,082200,Arapahoe County
97,1402,855,255,277,139,88,57,23,16,547,156,138,91,77,49,17,19,1402,766,89,547,3636,Census Tract 823,08,005,082300,Arapahoe County
98,1538,935,173,335,180,128,62,27,30,603,168,150,109,88,52,21,15,1538,788,147,603,4265,Census Tract 824,08,005,082400,Arapahoe County
99,760,642,106,236,107,97,52,25,19,118,15,23,19,23,12,10,16,760,535,107,118,2310,Census Tract 825,08,005,082500,Arapahoe County
100,2096,1070,386,321,135,112,53,29,34,1026,325,307,178,114,74,16,12,2096,1001,69,1026,5059,Census Tract 826,08,005,082600,Arapahoe County
101,1183,1001,210,318,175,159,74,40,25,182,11,40,42,40,22,11,16,1183,913,88,182,3499,Census Tract 827,08,005,082700,Arapahoe County
102,1846,1445,339,491,268,197,89,38,23,401,79,94,61,85,48,18,16,1846,1304,141,401,5030,Census Tract 828,08,005,082800,Arapahoe County
103,1663,1355,324,441,247,209,75,38,21,308,63,69,57,52,31,20,16,1663,1282,73,308,4522,Census Tract 829,08,005,082900,Arapahoe County
104,1140,1037,134,405,204,189,66,26,13,103,10,17,26,25,20,4,1,1140,986,51,103,3245,Census Tract 830,08,005,083000,Arapahoe County
105,2518,1758,387,516,317,302,127,66,43,760,260,214,126,100,38,11,11,2518,1683,75,760,6739,Census Tract 831,08,005,083100,Arapahoe County
106,2672,2373,244,633,480,626,243,113,34,299,25,51,75,68,50,20,10,2672,2314,59,299,8692,Census Tract 832,08,005,083200,Arapahoe County
107,1771,1489,413,543,246,178,58,33,18,282,56,86,60,38,24,9,9,1771,1323,166,282,4399,Census Tract 833,08,005,083300,Arapahoe County
108,2151,1874,256,572,392,382,167,66,39,277,18,59,47,72,48,19,14,2151,1732,142,277,6685,Census Tract 834,08,005,083400,Arapahoe County
109,1964,1143,198,410,205,177,80,44,29,821,303,194,139,78,59,29,19,1964,1030,113,821,5274,Census Tract 835,08,005,083500,Arapahoe County
110,1673,903,369,299,134,75,16,5,5,770,245,205,158,117,29,13,3,1673,799,104,770,3661,Census Tract 836,08,005,083600,Arapahoe County
111,1678,1210,213,508,229,163,65,22,10,468,155,134,83,52,24,11,9,1678,1025,185,468,4356,Census Tract 837,08,005,083700,Arapahoe County
112,1113,864,268,315,125,95,42,12,7,249,56,74,48,40,19,7,5,1113,739,125,249,2842,Census Tract 838,08,005,083800,Arapahoe County
113,1552,857,452,284,70,36,10,3,2,695,276,235,112,51,17,3,1,1552,753,104,695,2853,Census Tract 839,08,005,083900,Arapahoe County
114,777,615,109,198,119,109,44,25,11,162,15,40,31,40,14,11,11,777,544,71,162,2327,Census Tract 840,08,005,084000,Arapahoe County
115,1576,1179,243,375,220,200,80,28,33,397,95,85,80,75,36,17,9,1576,1064,115,397,4435,Census Tract 841,08,005,084100,Arapahoe County
116,1304,974,231,297,194,148,59,26,19,330,78,78,58,64,37,9,6,1304,908,66,330,3548,Census Tract 842,08,005,084200,Arapahoe County
117,1177,984,163,333,207,172,64,30,15,193,22,23,42,54,29,15,8,1177,919,65,193,3456,Census Tract 843,08,005,084300,Arapahoe County
118,1030,817,128,256,174,153,67,19,20,213,20,38,41,60,30,15,9,1030,778,39,213,3143,Census Tract 844,08,005,084400,Arapahoe County
119,1207,380,52,160,67,59,23,12,7,827,394,217,109,62,29,14,2,1207,303,77,827,2708,Census Tract 845,08,005,084500,Arapahoe County
120,1967,1232,269,422,227,186,81,27,20,735,229,188,116,101,61,22,18,1967,1081,151,735,5196,Census Tract 846,08,005,084600,Arapahoe County
121,1689,1390,300,486,277,190,81,33,23,299,37,67,63,63,36,18,15,1689,1208,182,299,4665,Census Tract 847,08,005,084700,Arapahoe County
122,1164,1033,159,312,233,204,85,28,12,131,12,26,30,29,21,10,3,1164,984,49,131,3444,Census Tract 848,08,005,084800,Arapahoe County
123,1013,977,62,371,209,211,87,28,9,36,6,5,8,8,6,1,2,1013,840,137,36,3066,Census Tract 849,08,005,084900,Arapahoe County
124,606,382,27,95,64,117,47,23,9,224,92,65,34,17,9,3,4,606,340,42,224,1805,Census Tract 850,08,005,085000,Arapahoe County
125,1907,1776,93,378,379,582,224,86,34,131,11,15,19,50,24,5,7,1907,1670,106,131,6698,Census Tract 851,08,005,085100,Arapahoe County
126,898,859,73,273,171,228,80,20,14,39,3,10,10,7,7,2,0,898,770,89,39,2809,Census Tract 852,08,005,085200,Arapahoe County
127,893,604,96,234,114,107,36,10,7,289,86,111,45,32,8,4,3,893,546,58,289,2284,Census Tract 853,08,005,085300,Arapahoe County
128,1381,1263,114,421,262,291,112,49,14,118,8,22,16,34,23,11,4,1381,1173,90,118,4320,Census Tract 854,08,005,085400,Arapahoe County
129,1706,1553,149,516,329,332,143,56,28,153,10,30,31,42,21,14,5,1706,1386,167,153,5316,Census Tract 855,08,005,085500,Arapahoe County
130,990,934,62,247,241,254,94,32,4,56,1,10,10,17,13,4,1,990,881,53,56,3203,Census Tract 856,08,005,085600,Arapahoe County
131,1738,1285,335,380,256,193,81,26,14,453,91,129,93,73,42,17,8,1738,1226,59,453,4611,Census Tract 857,08,005,085700,Arapahoe County
132,617,503,92,157,122,75,39,13,5,114,28,30,24,14,9,6,3,617,456,47,114,1706,Census Tract 858,08,005,085800,Arapahoe County
133,975,892,100,214,187,225,96,51,19,83,2,18,13,25,13,9,3,975,853,39,83,3248,Census Tract 859,08,005,085900,Arapahoe County
134,2419,1867,224,472,384,467,221,67,32,552,98,108,133,98,75,24,16,2419,1807,60,552,7684,Census Tract 860,08,005,086000,Arapahoe County
135,1492,1308,139,354,319,296,117,56,27,184,8,31,50,51,27,13,4,1492,1257,51,184,4784,Census Tract 861,08,005,086100,Arapahoe County
136,1798,1607,159,414,376,408,161,60,29,191,9,35,47,63,23,12,2,1798,1544,63,191,5814,Census Tract 862,08,005,086200,Arapahoe County
137,1521,871,198,284,176,138,56,12,7,650,221,221,109,70,19,9,1,1521,792,79,650,3696,Census Tract 863,08,005,086300,Arapahoe County
138,693,663,55,291,122,124,43,16,12,30,3,14,6,5,1,0,1,693,531,132,30,1980,Census Tract 864,08,005,086400,Arapahoe County
139,1889,1205,287,423,189,193,74,31,8,684,235,208,128,66,37,9,1,1889,1097,108,684,4632,Census Tract 865,08,005,086500,Arapahoe County
140,1916,1716,412,985,141,121,36,15,6,200,65,67,25,24,14,4,1,1916,1270,446,200,4075,Census Tract 866,08,005,086600,Arapahoe County
141,1067,1026,50,279,202,314,130,35,16,41,2,6,8,12,7,2,4,1067,981,45,41,3611,Census Tract 867,08,005,086700,Arapahoe County
142,2989,1173,511,352,159,100,39,8,4,1816,789,532,249,151,57,27,11,2989,1030,143,1816,6106,Census Tract 868,08,005,086800,Arapahoe County
143,1330,265,119,97,24,21,4,0,0,1065,390,330,186,99,39,15,6,1330,235,30,1065,2823,Census Tract 869,08,005,086900,Arapahoe County
144,2161,465,223,162,47,24,8,1,0,1696,613,563,250,158,83,23,6,2161,417,48,1696,4550,Census Tract 870,08,005,087000,Arapahoe County
145,1387,427,248,127,30,12,4,3,3,960,469,289,109,56,23,10,4,1387,352,75,960,2505,Census Tract 871,08,005,087100,Arapahoe County
146,1832,596,192,244,68,63,27,2,0,1236,519,412,161,92,37,9,6,1832,437,159,1236,3768,Census Tract 872,08,005,087200,Arapahoe County
147,3098,583,263,216,55,38,6,3,2,2515,912,706,365,306,139,58,29,3098,465,118,2515,7087,Census Tract 873,08,005,087300,Arapahoe County
1,540,452,123,231,52,27,10,7,2,88,29,26,9,10,6,5,3,540,224,228,88,1188,Census Tract 9404,08,007,940400,Archuleta County
2,2323,1667,416,803,209,156,58,18,7,656,228,195,102,63,39,19,10,2323,1201,466,656,5349,Census Tract 9742,08,007,974200,Archuleta County
3,1491,1147,234,607,139,109,36,14,8,344,142,92,43,28,21,15,3,1491,758,389,344,3487,Census Tract 9743,08,007,974300,Archuleta County
4,913,681,159,363,62,63,17,12,5,232,77,72,39,24,13,4,3,913,407,274,232,2060,Census Tract 9744,08,007,974400,Archuleta County
1,768,561,151,257,63,49,29,8,4,207,99,47,25,16,12,7,1,768,234,327,207,1738,Census Tract 9646,08,009,964600,Baca County
2,917,666,211,278,81,54,27,13,2,251,129,40,29,36,11,3,3,917,336,330,251,2050,Census Tract 9647,08,009,964700,Baca County
1,1832,1224,358,496,159,113,62,25,11,608,228,151,82,80,43,16,8,1832,632,592,608,6499,Census Tract 9667,08,011,966700,Bent County
1,1987,1372,296,504,213,264,74,17,4,615,249,213,78,48,19,3,5,1987,989,383,615,4770,Census Tract 121.01,08,013,012101,Boulder County
2,2934,1757,586,671,245,201,43,9,2,1177,396,426,201,100,31,15,8,2934,1210,547,1177,6466,Census Tract 121.02,08,013,012102,Boulder County
3,1686,1083,248,461,182,140,34,11,7,603,256,194,74,45,24,7,3,1686,795,288,603,3804,Census Tract 121.03,08,013,012103,Boulder County
4,1029,856,171,346,160,133,38,6,2,173,57,51,28,27,5,3,2,1029,601,255,173,2538,Census Tract 121.04,08,013,012104,Boulder County
5,2251,1667,419,571,252,269,102,35,19,584,229,167,79,60,31,6,12,2251,1098,569,584,5589,Census Tract 121.05,08,013,012105,Boulder County
6,1622,739,201,308,105,87,35,2,1,883,377,302,126,54,16,6,2,1622,508,231,883,3388,Census Tract 122.01,08,013,012201,Boulder County
7,3142,623,321,211,55,29,5,2,0,2519,1186,755,338,211,21,6,2,3142,466,157,2519,5847,Census Tract 122.02,08,013,012202,Boulder County
8,3064,1489,691,520,150,88,25,13,2,1575,657,510,184,100,72,32,20,3064,1003,486,1575,6081,Census Tract 122.03,08,013,012203,Boulder County
9,1801,339,133,134,35,25,11,1,0,1462,736,465,166,65,17,7,6,1801,247,92,1462,3556,Census Tract 122.04,08,013,012204,Boulder County
10,754,13,6,6,0,0,1,0,0,741,227,295,109,82,24,4,0,754,8,5,741,6196,Census Tract 123,08,013,012300,Boulder County
11,1934,342,87,125,56,44,21,6,3,1592,511,365,329,235,81,37,34,1934,228,114,1592,5699,Census Tract 124.01,08,013,012401,Boulder County
12,1144,701,216,285,97,71,24,4,4,443,153,188,47,37,14,2,2,1144,514,187,443,2451,Census Tract 125.01,08,013,012501,Boulder County
13,1705,1162,197,522,194,187,49,7,6,543,191,167,95,65,20,4,1,1705,722,440,543,4102,Census Tract 125.05,08,013,012505,Boulder County
14,1678,772,197,306,132,108,16,12,1,906,170,314,221,107,60,28,6,1678,579,193,906,4202,Census Tract 125.07,08,013,012507,Boulder County
15,1308,593,190,218,90,75,15,4,1,715,243,277,105,48,31,7,4,1308,431,162,715,2833,Census Tract 125.08,08,013,012508,Boulder County
16,1277,990,194,357,202,183,46,6,2,287,104,66,50,41,18,5,3,1277,685,305,287,3247,Census Tract 125.09,08,013,012509,Boulder County
17,1915,1498,398,613,243,184,49,9,2,417,132,159,69,44,9,3,1,1915,1059,439,417,4316,Census Tract 125.10,08,013,012510,Boulder County
18,2685,695,230,278,82,75,24,5,1,1990,1268,399,123,178,19,2,1,2685,421,274,1990,6265,Census Tract 125.11,08,013,012511,Boulder County
19,1461,926,177,380,151,171,35,11,1,535,207,199,79,37,7,5,1,1461,626,300,535,3384,Census Tract 126.03,08,013,012603,Boulder County
20,709,109,46,46,12,5,0,0,0,600,175,246,98,46,24,8,3,709,76,33,600,1529,Census Tract 126.05,08,013,012605,Boulder County
21,2650,203,88,74,19,15,6,1,0,2447,1483,674,180,80,20,8,2,2650,148,55,2447,4258,Census Tract 126.07,08,013,012607,Boulder County
22,964,523,174,221,76,35,10,5,2,441,118,141,110,48,21,1,2,964,406,117,441,2239,Census Tract 126.08,08,013,012608,Boulder County
23,2157,1817,355,727,306,318,88,19,4,340,100,149,48,28,8,5,2,2157,1408,409,340,5448,Census Tract 127.01,08,013,012701,Boulder County
24,1938,966,430,335,97,83,17,3,1,972,455,379,102,28,7,0,1,1938,811,155,972,3507,Census Tract 127.05,08,013,012705,Boulder County
25,664,587,127,204,88,97,44,18,9,77,24,26,13,6,6,1,1,664,309,278,77,2194,Census Tract 127.07,08,013,012707,Boulder County
26,2152,1833,381,801,294,254,80,18,5,319,104,117,58,24,8,6,2,2152,1392,441,319,5123,Census Tract 127.08,08,013,012708,Boulder County
27,692,637,110,270,104,112,32,5,4,55,5,13,15,14,3,4,1,692,462,175,55,1811,Census Tract 127.09,08,013,012709,Boulder County
28,1469,1203,225,512,201,191,51,17,6,266,88,71,37,42,16,10,2,1469,822,381,266,3685,Census Tract 127.10,08,013,012710,Boulder County
29,3709,3410,407,1176,673,765,284,81,24,299,46,84,69,52,29,11,8,3709,3015,395,299,10822,Census Tract 128,08,013,012800,Boulder County
30,894,783,163,330,119,129,29,9,4,111,25,39,25,18,3,1,0,894,658,125,111,2195,Census Tract 129.03,08,013,012903,Boulder County
31,2060,1535,320,551,321,243,75,12,13,525,217,133,79,54,27,6,9,2060,1332,203,525,5156,Census Tract 129.04,08,013,012904,Boulder County
32,1012,543,132,204,88,75,29,6,9,469,188,108,79,49,25,12,8,1012,427,116,469,2481,Census Tract 129.05,08,013,012905,Boulder County
33,1167,913,213,352,178,117,33,15,5,254,59,74,53,31,19,10,8,1167,768,145,254,2922,Census Tract 129.07,08,013,012907,Boulder County
34,2188,1737,328,637,356,291,85,31,9,451,181,134,77,42,16,1,0,2188,1357,380,451,5452,Census Tract 130.03,08,013,013003,Boulder County
35,1196,1060,157,345,223,238,74,16,7,136,20,34,25,34,14,8,1,1196,829,231,136,3414,Census Tract 130.04,08,013,013004,Boulder County
36,1276,852,167,316,153,162,36,12,6,424,177,127,64,33,18,3,2,1276,652,200,424,3084,Census Tract 130.05,08,013,013005,Boulder County
37,2178,1632,342,557,329,320,64,15,5,546,249,136,74,64,16,4,3,2178,1360,272,546,5304,Census Tract 130.06,08,013,013006,Boulder County
38,599,541,69,305,70,70,16,8,3,58,10,21,7,8,5,1,6,599,362,179,58,1531,Census Tract 132.01,08,013,013201,Boulder County
39,551,487,59,252,85,63,21,5,2,64,24,21,5,7,4,2,1,551,334,153,64,1375,Census Tract 132.02,08,013,013202,Boulder County
40,1998,1707,297,634,323,304,118,23,8,291,147,76,37,22,9,0,0,1998,1305,402,291,5078,Census Tract 132.05,08,013,013205,Boulder County
41,1785,1155,150,526,206,180,70,14,9,630,303,181,74,44,19,4,5,1785,873,282,630,4276,Census Tract 132.07,08,013,013207,Boulder County
42,2452,1722,389,760,248,210,69,33,13,730,335,186,84,63,33,14,15,2452,1176,546,730,5755,Census Tract 132.08,08,013,013208,Boulder County
43,1745,1179,200,427,230,146,97,43,36,566,139,119,112,107,47,21,21,1745,917,262,566,5032,Census Tract 132.10,08,013,013210,Boulder County
44,2039,1633,295,570,294,287,120,46,21,406,111,109,72,51,33,20,10,2039,1262,371,406,5612,Census Tract 132.11,08,013,013211,Boulder County
45,1815,1214,287,417,193,214,69,20,14,601,271,156,90,57,21,6,0,1815,1011,203,601,4345,Census Tract 132.12,08,013,013212,Boulder County
46,2792,1565,290,434,303,376,118,37,7,1227,429,366,193,137,76,20,6,2792,1383,182,1227,7271,Census Tract 132.13,08,013,013213,Boulder County
47,2326,1385,393,530,217,165,56,17,7,941,460,233,110,71,38,15,14,2326,1034,351,941,5132,Census Tract 133.02,08,013,013302,Boulder County
48,1865,1248,250,466,229,180,73,31,19,617,183,183,106,74,41,19,11,1865,1115,133,617,4859,Census Tract 133.05,08,013,013305,Boulder County
49,1658,848,185,336,138,97,50,21,21,810,272,183,144,106,56,25,24,1658,693,155,810,4589,Census Tract 133.06,08,013,013306,Boulder County
50,1580,782,277,325,84,60,22,10,4,798,275,216,147,94,44,13,9,1580,487,295,798,3604,Census Tract 133.07,08,013,013307,Boulder County
51,1583,991,423,370,100,57,19,14,8,592,218,151,103,63,35,13,9,1583,583,408,592,3465,Census Tract 133.08,08,013,013308,Boulder County
52,1368,536,161,192,80,48,27,21,7,832,342,216,117,71,50,18,18,1368,438,98,832,3275,Census Tract 134.01,08,013,013401,Boulder County
53,2733,1978,435,796,274,248,115,60,50,755,149,184,143,112,87,36,44,2733,1660,318,755,7573,Census Tract 134.02,08,013,013402,Boulder County
54,1882,921,226,298,141,102,72,45,37,961,252,196,153,167,103,52,38,1882,766,155,961,5478,Census Tract 135.03,08,013,013503,Boulder County
55,1551,617,203,230,83,51,21,12,17,934,338,211,132,125,74,37,17,1551,458,159,934,3831,Census Tract 135.05,08,013,013505,Boulder County
56,1367,1180,169,454,183,215,100,36,23,187,28,38,30,35,24,18,14,1367,1018,162,187,4058,Census Tract 135.06,08,013,013506,Boulder County
57,1133,929,176,332,152,131,74,30,34,204,26,47,35,29,40,9,18,1133,787,142,204,3397,Census Tract 135.07,08,013,013507,Boulder County
58,2334,1867,295,633,288,405,161,65,20,467,123,155,75,65,30,13,6,2334,1643,224,467,6575,Census Tract 135.08,08,013,013508,Boulder County
59,1649,1267,276,536,201,198,36,16,4,382,159,122,53,29,12,5,2,1649,927,340,382,3831,Census Tract 136.01,08,013,013601,Boulder County
60,471,362,107,193,33,20,6,1,2,109,59,33,11,5,1,0,0,471,226,136,109,912,Census Tract 136.02,08,013,013602,Boulder County
61,2744,2301,537,1052,334,280,81,12,5,443,183,146,72,24,13,5,0,2744,1657,644,443,6334,Census Tract 137.01,08,013,013701,Boulder County
62,2743,2098,516,934,338,239,47,16,8,645,318,182,87,44,10,2,2,2743,1624,474,645,5952,Census Tract 137.02,08,013,013702,Boulder County
63,2356,923,211,298,167,162,57,20,8,1433,527,556,193,117,24,12,4,2356,808,115,1433,5325,Census Tract 606,08,013,060600,Boulder County
64,1319,937,199,346,158,171,50,10,3,382,208,108,37,18,10,0,1,1319,731,206,382,3091,Census Tract 607,08,013,060700,Boulder County
65,2380,1421,397,472,222,164,84,41,41,959,300,250,163,128,77,25,16,2380,892,529,959,6107,Census Tract 608,08,013,060800,Boulder County
66,1780,1280,410,428,181,183,54,15,9,500,172,150,93,43,23,12,7,1780,1136,144,500,4139,Census Tract 609,08,013,060900,Boulder County
67,997,925,52,191,219,312,108,34,9,72,6,8,15,23,14,4,2,997,830,95,72,3417,Census Tract 613,08,013,061300,Boulder County
68,1253,1034,104,221,241,336,106,19,7,219,30,53,48,54,22,10,2,1253,959,75,219,3990,Census Tract 614,08,013,061400,Boulder County
1,1364,713,162,270,124,89,31,22,15,651,269,155,83,68,42,23,11,1364,515,198,651,3378,Census Tract 300,08,014,030000,Broomfield County
2,893,601,129,254,102,61,28,14,13,292,130,61,42,26,19,7,7,893,424,177,292,2183,Census Tract 301,08,014,030100,Broomfield County
3,642,461,123,155,90,60,23,7,3,181,34,43,38,40,15,6,5,642,388,73,181,1672,Census Tract 302,08,014,030200,Broomfield County
4,1665,657,104,251,132,105,43,13,9,1008,585,250,89,47,26,9,2,1665,523,134,1008,3707,Census Tract 303,08,014,030300,Broomfield County
5,1324,1206,157,479,233,194,94,37,12,118,11,20,32,26,15,10,4,1324,938,268,118,3789,Census Tract 304,08,014,030400,Broomfield County
6,1988,1780,202,571,324,457,161,46,19,208,65,49,40,28,15,8,3,1988,1615,165,208,5911,Census Tract 305,08,014,030500,Broomfield County
7,2046,1771,293,563,320,333,163,62,37,275,29,43,65,63,40,22,13,2046,1443,328,275,6166,Census Tract 306,08,014,030600,Broomfield County
8,1147,839,176,316,143,143,42,13,6,308,67,97,57,49,28,6,4,1147,744,95,308,2988,Census Tract 307,08,014,030700,Broomfield County
9,1851,1611,246,518,323,341,122,44,17,240,24,48,64,54,32,12,6,1851,1388,223,240,5420,Census Tract 308,08,014,030800,Broomfield County
10,2183,1977,342,711,322,379,173,32,18,206,59,72,27,28,13,6,1,2183,1544,433,206,5938,Census Tract 309,08,014,030900,Broomfield County
11,1903,1640,412,521,250,315,113,23,6,263,62,103,52,29,13,3,1,1903,1459,181,263,4841,Census Tract 310,08,014,031000,Broomfield County
12,1508,9,1,3,1,4,0,0,0,1499,759,561,131,38,8,1,1,1508,7,2,1499,2606,Census Tract 311,08,014,031100,Broomfield County
13,1283,707,170,262,119,98,35,15,8,576,214,177,82,63,24,9,7,1283,599,108,576,3059,Census Tract 312,08,014,031200,Broomfield County
14,558,523,74,172,88,112,61,9,7,35,8,6,6,10,4,1,0,558,456,67,35,1648,Census Tract 313,08,014,031300,Broomfield County
15,1059,1002,199,480,111,125,73,10,4,57,17,21,6,9,2,0,2,1059,723,279,57,2583,Census Tract 314,08,014,031400,Broomfield County
16,0,0,0,0,0,0,0,0,0,0,0,0,0,0,0,0,0,0,0,0,0,0,Census Tract 9801,08,014,980100,Broomfield County
17,0,0,0,0,0,0,0,0,0,0,0,0,0,0,0,0,0,0,0,0,0,0,Census Tract 9802,08,014,980200,Broomfield County
18,0,0,0,0,0,0,0,0,0,0,0,0,0,0,0,0,0,0,0,0,0,0,Census Tract 9803,08,014,980300,Broomfield County
1,1225,702,235,295,94,58,12,6,2,523,232,136,86,45,12,9,3,1225,413,289,523,2541,Census Tract 1,08,015,000100,Chaffee County
2,1973,1380,373,658,174,127,38,5,5,593,300,143,70,48,27,4,1,1973,773,607,593,4305,Census Tract 2,08,015,000200,Chaffee County
3,1319,1054,217,616,89,96,30,2,4,265,83,88,44,30,15,4,1,1319,682,372,265,2909,Census Tract 3,08,015,000300,Chaffee County
4,2063,1580,354,863,168,126,41,21,7,483,205,136,59,48,23,8,4,2063,967,613,483,4531,Census Tract 4.01,08,015,000401,Chaffee County
5,1021,793,208,390,83,61,38,9,4,228,80,64,42,28,8,4,2,1021,452,341,228,3523,Census Tract 4.02,08,015,000402,Chaffee County
1,786,598,179,252,69,49,33,11,5,188,87,36,19,20,19,4,3,786,256,342,188,1836,Census Tract 9606,08,017,960600,Cheyenne County
1,2226,1922,443,949,248,212,52,15,3,304,122,97,41,29,10,4,1,2226,1512,410,304,4959,Census Tract 147,08,019,014700,Clear Creek County
2,772,451,135,207,47,39,19,1,3,321,158,93,26,25,14,3,2,772,315,136,321,1610,Census Tract 148,08,019,014800,Clear Creek County
3,1210,854,295,343,95,81,27,6,7,356,189,96,43,19,6,1,2,1210,583,271,356,2519,Census Tract 149,08,019,014900,Clear Creek County
1,1487,1145,324,357,157,146,82,45,34,342,116,98,52,38,29,5,4,1487,545,600,342,3887,Census Tract 9748,08,021,974800,Conejos County
2,1631,1263,298,452,157,191,86,42,37,368,118,96,56,44,23,23,8,1631,628,635,368,4369,Census Tract 9749,08,021,974900,Conejos County
1,704,567,159,259,49,43,31,17,9,137,54,29,27,15,8,3,1,704,241,326,137,1646,Census Tract 9726,08,023,972600,Costilla County
2,846,628,209,240,82,43,28,15,11,218,98,55,30,21,9,5,0,846,222,406,218,1878,Census Tract 9727,08,023,972700,Costilla County
1,1306,930,260,392,113,76,52,23,14,376,134,85,71,43,21,14,8,1306,553,377,376,5823,Census Tract 9696,08,025,969600,Crowley County
1,1925,1562,420,842,131,95,40,19,15,363,160,100,29,52,9,8,5,1925,915,647,363,4255,Census Tract 9701,08,027,970100,Custer County
1,1762,1306,339,602,176,120,40,22,7,456,193,109,64,52,20,13,5,1762,752,554,456,4003,Census Tract 9646,08,029,964600,Delta County
2,1718,1407,321,709,160,117,52,30,18,311,107,76,52,39,22,9,6,1718,813,594,311,4092,Census Tract 9647,08,029,964700,Delta County
3,1197,867,202,356,122,96,50,30,11,330,122,80,55,36,22,6,9,1197,521,346,330,3493,Census Tract 9648,08,029,964800,Delta County
4,2140,1664,337,655,213,252,118,52,37,476,144,111,82,68,48,15,8,2140,1128,536,476,5805,Census Tract 9649,08,029,964900,Delta County
5,2134,1662,423,763,205,155,69,33,14,472,162,122,59,73,43,8,5,2134,922,740,472,5017,Census Tract 9650,08,029,965000,Delta County
6,1697,1023,270,425,129,112,52,23,12,674,271,161,102,71,46,16,7,1697,667,356,674,4078,Census Tract 9651,08,029,965100,Delta County
7,2055,1640,435,855,164,103,48,17,18,415,160,117,69,34,24,5,6,2055,937,703,415,4464,Census Tract 9652,08,029,965200,Delta County
1,1497,1038,368,395,146,84,24,17,4,459,192,152,52,46,13,3,1,1497,838,200,459,3109,Census Tract 1.02,08,031,000102,Denver County
2,1416,1042,286,351,148,111,76,28,42,374,136,77,56,48,34,15,8,1416,857,185,374,3874,Census Tract 2.01,08,031,000201,Denver County
3,1505,928,275,331,130,98,50,20,24,577,161,146,102,84,28,34,22,1505,774,154,577,3916,Census Tract 2.02,08,031,000202,Denver County
4,2552,1551,535,622,207,137,30,9,11,1001,573,266,86,45,17,12,2,2552,1292,259,1001,5003,Census Tract 3.01,08,031,000301,Denver County
5,2018,1294,434,503,211,104,25,14,3,724,355,256,69,26,11,5,2,2018,1064,230,724,4036,Census Tract 3.02,08,031,000302,Denver County
6,2238,1371,500,516,188,132,25,6,4,867,475,256,74,36,18,3,5,2238,1164,207,867,4504,Census Tract 3.03,08,031,000303,Denver County
7,1365,781,189,318,128,82,35,13,16,584,245,167,80,42,31,7,12,1365,659,122,584,3209,Census Tract 4.01,08,031,000401,Denver County
8,2610,1235,487,417,157,110,34,12,18,1375,737,370,133,67,30,21,17,2610,1070,165,1375,5314,Census Tract 4.02,08,031,000402,Denver County
9,901,640,236,239,96,48,16,3,2,261,112,84,41,17,5,2,0,901,509,131,261,1814,Census Tract 5.01,08,031,000501,Denver County
10,2598,1280,401,520,196,120,18,14,11,1318,672,332,135,90,45,24,20,2598,1073,207,1318,5424,Census Tract 5.02,08,031,000502,Denver County
11,1182,378,159,136,40,20,15,2,6,804,333,233,91,69,51,16,11,1182,339,39,804,2552,Census Tract 6,08,031,000600,Denver County
12,1737,513,152,174,57,53,25,22,30,1224,621,243,128,98,67,40,27,1737,406,107,1224,4166,Census Tract 7.01,08,031,000701,Denver County
13,1966,444,117,147,66,49,30,16,19,1522,435,361,264,210,136,65,51,1966,369,75,1522,5574,Census Tract 7.02,08,031,000702,Denver County
14,451,19,3,8,1,2,1,2,2,432,60,115,103,80,38,20,16,451,10,9,432,1448,Census Tract 8,08,031,000800,Denver County
15,1704,1157,254,357,169,139,125,53,60,547,127,108,57,96,69,36,54,1704,895,262,547,5376,Census Tract 9.02,08,031,000902,Denver County
16,1782,1002,224,271,142,136,97,58,74,780,118,143,131,128,106,69,85,1782,821,181,780,6111,Census Tract 9.03,08,031,000903,Denver County
17,1681,517,134,129,76,62,45,29,42,1164,361,221,155,154,144,68,61,1681,419,98,1164,5127,Census Tract 9.04,08,031,000904,Denver County
18,1138,668,169,174,97,90,59,40,39,470,79,97,84,86,51,46,27,1138,523,145,470,3631,Census Tract 9.05,08,031,000905,Denver County
19,1180,532,111,141,91,64,48,31,46,648,122,146,108,92,86,44,50,1180,435,97,648,3941,Census Tract 10,08,031,001000,Denver County
20,911,458,110,156,89,49,26,14,14,453,112,113,77,75,35,26,15,911,373,85,453,2601,Census Tract 11.01,08,031,001101,Denver County
21,1521,611,211,228,84,51,19,10,8,910,408,320,89,47,28,12,6,1521,504,107,910,3115,Census Tract 11.02,08,031,001102,Denver County
22,1529,941,224,270,149,111,82,52,53,588,80,116,104,114,88,40,46,1529,743,198,588,4972,Census Tract 13.01,08,031,001301,Denver County
23,1252,799,208,231,125,103,56,37,39,453,58,90,90,79,60,39,37,1252,593,206,453,3926,Census Tract 13.02,08,031,001302,Denver County
24,1971,923,191,274,133,129,86,58,52,1048,435,167,118,129,70,62,67,1971,715,208,1048,5750,Census Tract 14.01,08,031,001401,Denver County
25,1353,766,175,238,125,88,61,37,42,587,183,94,75,103,54,40,38,1353,600,166,587,4070,Census Tract 14.02,08,031,001402,Denver County
26,1044,450,175,155,50,32,21,11,6,594,259,209,59,30,21,7,9,1044,364,86,594,2218,Census Tract 14.03,08,031,001403,Denver County
27,1040,465,114,136,65,49,47,28,26,575,178,104,77,83,76,33,24,1040,316,149,575,3687,Census Tract 15,08,031,001500,Denver County
28,3771,868,438,307,75,23,10,7,8,2903,1613,954,194,84,27,14,17,3771,772,96,2903,7685,Census Tract 16,08,031,001600,Denver County
29,3070,1227,628,533,52,13,1,0,0,1843,1307,486,43,4,3,0,0,3070,965,262,1843,4350,Census Tract 17.01,08,031,001701,Denver County
30,2363,387,261,109,14,3,0,0,0,1976,1506,382,52,34,1,0,1,2363,309,78,1976,3648,Census Tract 17.02,08,031,001702,Denver County
31,1727,496,249,166,43,21,8,1,8,1231,598,454,99,34,18,13,15,1727,418,78,1231,3209,Census Tract 18,08,031,001800,Denver County
32,1014,266,93,81,41,23,14,6,8,748,219,183,136,104,54,31,21,1014,210,56,748,2910,Census Tract 19.01,08,031,001901,Denver County
33,60,39,23,16,0,0,0,0,0,21,14,6,1,0,0,0,0,60,34,5,21,705,Census Tract 19.02,08,031,001902,Denver County
34,1140,294,158,127,9,0,0,0,0,846,586,238,18,3,1,0,0,1140,242,52,846,1577,Census Tract 20,08,031,002000,Denver County
35,2447,1085,414,392,156,71,21,13,18,1362,723,379,135,50,26,20,29,2447,915,170,1362,4879,Census Tract 21,08,031,002100,Denver County
36,1993,1145,371,415,193,97,33,21,15,848,264,235,147,98,39,33,32,1993,996,149,848,4831,Census Tract 23,08,031,002300,Denver County
37,818,331,117,138,39,28,6,2,1,487,226,147,64,32,14,4,0,818,296,35,487,1687,Census Tract 24.02,08,031,002402,Denver County
38,1817,575,260,225,46,24,10,5,5,1242,693,330,108,64,27,11,9,1817,503,72,1242,3338,Census Tract 24.03,08,031,002403,Denver County
39,2165,226,123,93,8,2,0,0,0,1939,1491,391,42,12,1,1,1,2165,210,16,1939,3087,Census Tract 26.01,08,031,002601,Denver County
40,1686,380,198,161,13,5,2,1,0,1306,890,349,46,17,1,1,2,1686,348,32,1306,2736,Census Tract 26.02,08,031,002602,Denver County
41,3538,438,286,127,17,5,1,2,0,3100,2367,652,68,10,2,0,1,3538,374,64,3100,4600,Census Tract 27.01,08,031,002701,Denver County
42,3775,1112,718,335,46,8,3,1,1,2663,1860,684,91,21,4,1,2,3775,900,212,2663,5323,Census Tract 27.02,08,031,002702,Denver County
43,3543,658,401,213,27,14,2,1,0,2885,2164,612,78,19,9,2,1,3543,587,71,2885,4785,Census Tract 27.03,08,031,002703,Denver County
44,1598,699,342,249,68,30,7,3,0,899,553,261,62,17,4,2,0,1598,565,134,899,2583,Census Tract 28.01,08,031,002801,Denver County
45,2683,765,358,275,74,43,10,4,1,1918,1270,473,120,37,15,2,1,2683,660,105,1918,4213,Census Tract 28.02,08,031,002802,Denver County
46,3023,702,431,187,61,22,0,1,0,2321,1692,537,69,13,9,1,0,3023,585,117,2321,4158,Census Tract 28.03,08,031,002803,Denver County
47,1472,716,279,286,79,57,11,3,1,756,443,219,66,21,4,3,0,1472,603,113,756,2602,Census Tract 29.01,08,031,002901,Denver County
48,1893,1261,434,515,161,116,25,7,3,632,274,223,95,28,8,4,0,1893,1033,228,632,3791,Census Tract 29.02,08,031,002902,Denver County
49,2677,1734,560,703,251,175,32,9,4,943,407,367,115,42,7,1,4,2677,1420,314,943,5393,Census Tract 30.01,08,031,003001,Denver County
50,1293,647,221,263,97,44,17,2,3,646,318,196,84,30,12,3,3,1293,533,114,646,2553,Census Tract 30.02,08,031,003002,Denver County
51,1151,446,176,162,60,40,8,0,0,705,327,260,65,37,14,1,1,1151,357,89,705,3138,Census Tract 30.03,08,031,003003,Denver County
52,2608,1170,438,411,169,120,23,7,2,1438,666,470,170,103,22,5,2,2608,868,302,1438,6237,Census Tract 30.04,08,031,003004,Denver County
53,761,355,136,144,48,22,2,2,1,406,219,104,33,29,12,4,5,761,308,47,406,1455,Census Tract 31.01,08,031,003101,Denver County
54,1813,392,194,136,38,21,1,2,0,1421,1020,292,65,35,4,4,1,1813,361,31,1421,3389,Census Tract 31.02,08,031,003102,Denver County
55,3386,989,544,358,47,32,7,1,0,2397,1601,657,96,29,10,2,2,3386,753,236,2397,4970,Census Tract 32.01,08,031,003201,Denver County
56,1957,548,275,199,34,27,12,1,0,1409,977,388,31,11,0,2,0,1957,429,119,1409,3001,Census Tract 32.02,08,031,003202,Denver County
57,1289,1050,221,460,141,139,73,14,2,239,121,78,22,16,1,1,0,1289,723,327,239,3001,Census Tract 32.03,08,031,003203,Denver County
58,1442,1004,264,405,154,129,48,4,0,438,211,156,39,24,5,1,2,1442,776,228,438,3099,Census Tract 33,08,031,003300,Denver County
59,1330,980,444,359,92,67,14,3,1,350,166,120,45,17,2,0,0,1330,671,309,350,2420,Census Tract 34.01,08,031,003401,Denver County
60,1977,1614,443,627,261,212,59,12,0,363,118,130,68,34,11,2,0,1977,1194,420,363,4485,Census Tract 34.02,08,031,003402,Denver County
61,1695,813,159,186,112,111,91,75,79,882,127,130,128,174,126,87,110,1695,601,212,882,6401,Census Tract 35,08,031,003500,Denver County
62,1595,755,203,240,104,87,54,30,37,840,259,168,137,85,84,49,58,1595,607,148,840,4651,Census Tract 36.01,08,031,003601,Denver County
63,1457,786,224,227,115,73,56,41,50,671,162,160,118,100,62,27,42,1457,623,163,671,4337,Census Tract 36.02,08,031,003602,Denver County
64,1381,850,291,307,122,73,20,22,15,531,247,123,63,49,26,13,10,1381,690,160,531,3106,Census Tract 36.03,08,031,003603,Denver County
65,1645,564,237,207,62,42,12,3,1,1081,651,320,76,21,10,3,0,1645,488,76,1081,2907,Census Tract 37.01,08,031,003701,Denver County
66,2699,854,358,312,94,70,16,4,0,1845,1274,436,84,36,12,1,2,2699,728,126,1845,4357,Census Tract 37.02,08,031,003702,Denver County
67,1583,568,218,208,85,42,10,4,1,1015,570,325,72,37,9,2,0,1583,489,79,1015,2779,Census Tract 37.03,08,031,003703,Denver County
68,3542,1673,724,766,117,47,18,1,0,1869,1278,423,112,43,12,1,0,3542,1217,456,1869,5589,Census Tract 38,08,031,003800,Denver County
69,2126,1691,580,736,171,147,42,12,3,435,244,132,34,22,1,1,1,2126,1048,643,435,4172,Census Tract 39.01,08,031,003901,Denver County
70,1771,1386,506,483,180,158,47,11,1,385,106,163,66,37,11,2,0,1771,1001,385,385,3892,Census Tract 39.02,08,031,003902,Denver County
71,1331,1174,319,463,159,174,49,8,2,157,45,46,29,26,7,3,1,1331,711,463,157,3133,Census Tract 40.02,08,031,004002,Denver County
72,1903,1365,509,528,163,122,36,3,4,538,126,196,104,66,25,17,4,1903,1043,322,538,4121,Census Tract 40.03,08,031,004003,Denver County
73,812,697,232,260,94,81,19,8,3,115,35,36,13,16,14,1,0,812,481,216,115,1808,Census Tract 40.04,08,031,004004,Denver County
74,1701,400,156,148,52,31,9,4,0,1301,774,323,92,92,14,3,3,1701,301,99,1301,3002,Census Tract 40.05,08,031,004005,Denver County
75,1962,1107,266,393,157,209,67,13,2,855,413,289,88,43,17,3,2,1962,775,332,855,4489,Census Tract 40.06,08,031,004006,Denver County
76,1366,534,176,170,80,50,32,15,11,832,275,219,108,103,60,30,37,1366,462,72,832,3648,Census Tract 41.01,08,031,004101,Denver County
77,1356,745,217,239,118,67,51,21,32,611,150,137,117,89,49,32,37,1356,557,188,611,4173,Census Tract 41.02,08,031,004102,Denver County
78,2087,1813,488,652,308,259,57,33,16,274,71,79,55,38,13,13,5,2087,1491,322,274,5093,Census Tract 41.03,08,031,004103,Denver County
79,1772,1352,452,483,181,133,57,23,23,420,94,134,73,54,32,21,12,1772,1108,244,420,4289,Census Tract 41.04,08,031,004104,Denver County
80,2441,2154,334,614,411,619,155,12,9,287,59,81,78,47,15,6,1,2441,2065,89,287,10138,Census Tract 41.06,08,031,004106,Denver County
81,1651,1023,268,315,162,200,58,12,8,628,320,199,60,28,13,7,1,1651,966,57,628,3810,Census Tract 41.07,08,031,004107,Denver County
82,1889,1467,323,556,240,259,74,10,5,422,204,122,49,32,9,5,1,1889,1172,295,422,4481,Census Tract 42.01,08,031,004201,Denver County
83,1560,1285,346,550,188,135,50,7,9,275,88,97,41,26,14,3,6,1560,1005,280,275,4109,Census Tract 42.02,08,031,004202,Denver County
84,2697,1047,519,334,100,76,10,8,0,1650,1053,407,123,47,14,5,1,2697,838,209,1650,4469,Census Tract 43.01,08,031,004301,Denver County
85,1187,850,288,337,121,86,12,5,1,337,139,115,44,28,7,3,1,1187,664,186,337,2467,Census Tract 43.02,08,031,004302,Denver County
86,1563,1418,271,557,222,244,98,20,6,145,30,40,39,23,11,1,1,1563,960,458,145,4067,Census Tract 43.03,08,031,004303,Denver County
87,2706,1860,697,670,264,178,28,18,5,846,364,293,117,52,7,10,3,2706,1509,351,846,5456,Census Tract 43.04,08,031,004304,Denver County
88,2118,1274,354,486,187,166,69,10,2,844,386,244,103,58,36,13,4,2118,918,356,844,4807,Census Tract 43.06,08,031,004306,Denver County
89,1869,858,303,294,113,62,42,23,21,1011,405,315,131,72,49,22,17,1869,722,136,1011,4213,Census Tract 44.03,08,031,004403,Denver County
90,2404,596,277,193,63,48,6,4,5,1808,611,443,248,204,167,65,70,2404,500,96,1808,5978,Census Tract 44.04,08,031,004404,Denver County
91,3487,1590,419,541,201,302,106,14,7,1897,1065,510,165,91,39,16,11,3487,1406,184,1897,7316,Census Tract 44.05,08,031,004405,Denver County
92,1154,510,100,130,75,73,61,35,36,644,130,96,98,119,102,53,46,1154,354,156,644,3974,Census Tract 45.03,08,031,004503,Denver County
93,1037,537,118,115,89,75,47,48,45,500,59,89,95,95,85,38,39,1037,423,114,500,3705,Census Tract 45.04,08,031,004504,Denver County
94,1168,470,90,112,71,57,60,29,51,698,93,108,107,141,112,69,68,1168,357,113,698,4357,Census Tract 45.05,08,031,004505,Denver County
95,981,384,81,85,62,52,38,35,31,597,105,103,93,111,89,48,48,981,303,81,597,3450,Census Tract 45.06,08,031,004506,Denver County
96,1823,1402,369,408,213,176,115,61,60,421,85,78,65,72,53,31,37,1823,1080,322,421,5415,Census Tract 46.01,08,031,004601,Denver County
97,2150,1073,259,302,157,148,103,49,55,1077,216,183,202,196,131,76,73,2150,856,217,1077,7037,Census Tract 46.02,08,031,004602,Denver County
98,1861,1318,373,399,209,159,88,38,52,543,75,126,124,104,53,33,28,1861,1060,258,543,5327,Census Tract 46.03,08,031,004603,Denver County
99,2129,1359,312,482,205,172,97,47,44,770,163,148,153,139,93,33,41,2129,953,406,770,6198,Census Tract 47,08,031,004700,Denver County
100,1043,921,236,325,129,112,72,22,25,122,15,29,15,24,22,7,10,1043,601,320,122,2858,Census Tract 48.01,08,031,004801,Denver County
101,1026,733,248,291,103,59,17,7,8,293,61,77,66,40,25,13,11,1026,543,190,293,2586,Census Tract 50.01,08,031,005001,Denver County
102,3281,1285,524,450,154,103,39,6,9,1996,896,595,258,147,65,24,11,3281,955,330,1996,6612,Census Tract 50.02,08,031,005002,Denver County
103,1545,1185,443,459,151,86,31,9,6,360,94,112,72,38,24,11,9,1545,868,317,360,3368,Census Tract 51.02,08,031,005102,Denver County
104,1503,345,132,136,38,27,8,2,2,1158,631,281,115,75,36,12,8,1503,259,86,1158,3111,Census Tract 51.04,08,031,005104,Denver County
105,1361,1153,358,485,139,124,35,6,6,208,62,52,36,32,16,6,4,1361,818,335,208,3052,Census Tract 52,08,031,005200,Denver County
106,606,294,103,119,35,25,9,1,2,312,189,72,26,13,6,3,3,606,225,69,312,1206,Census Tract 53,08,031,005300,Denver County
107,582,324,69,125,57,41,22,5,5,258,72,73,47,37,21,3,5,582,261,63,258,1856,Census Tract 55.02,08,031,005502,Denver County
108,1777,1410,336,567,203,177,78,27,22,367,125,66,60,59,26,19,12,1777,1057,353,367,4644,Census Tract 55.03,08,031,005503,Denver County
109,1323,90,42,43,3,2,0,0,0,1233,732,399,71,26,4,1,0,1323,63,27,1233,2018,Census Tract 67.01,08,031,006701,Denver County
110,1225,696,287,303,50,31,11,10,4,529,280,191,41,11,3,1,2,1225,460,236,529,2184,Census Tract 68.04,08,031,006804,Denver County
111,3518,1890,612,713,226,240,66,23,10,1628,933,446,144,58,25,14,8,3518,1338,552,1628,6979,Census Tract 68.09,08,031,006809,Denver County
112,2500,1471,590,526,162,121,44,13,15,1029,466,256,153,80,44,18,12,2500,1067,404,1029,5207,Census Tract 68.10,08,031,006810,Denver County
113,3210,1491,466,655,187,119,41,16,7,1719,1067,450,123,43,30,5,1,3210,1092,399,1719,5865,Census Tract 68.11,08,031,006811,Denver County
114,1716,1408,673,515,102,79,28,8,3,308,155,88,34,20,8,2,1,1716,824,584,308,3108,Census Tract 68.12,08,031,006812,Denver County
115,2296,556,318,183,33,13,6,2,1,1740,963,485,171,79,32,7,3,2296,433,123,1740,3871,Census Tract 68.13,08,031,006813,Denver County
116,2098,1060,346,433,148,95,24,11,3,1038,409,248,157,109,76,22,17,2098,740,320,1038,4703,Census Tract 68.14,08,031,006814,Denver County
117,2762,798,301,330,98,49,15,4,1,1964,987,495,200,143,74,40,25,2762,511,287,1964,5808,Census Tract 69.01,08,031,006901,Denver County
118,2261,17,7,10,0,0,0,0,0,2244,1021,657,300,175,60,22,9,2261,15,2,2244,4464,Census Tract 70.06,08,031,007006,Denver County
119,1785,1327,749,422,85,57,11,3,0,458,151,192,70,31,8,4,2,1785,1117,210,458,3096,Census Tract 70.13,08,031,007013,Denver County
120,1538,393,130,150,60,35,11,2,5,1145,410,293,142,130,102,42,26,1538,286,107,1145,3763,Census Tract 70.37,08,031,007037,Denver County
121,2310,467,242,197,19,5,2,2,0,1843,858,649,191,93,36,10,6,2310,279,188,1843,4168,Census Tract 70.88,08,031,007088,Denver County
122,3400,2388,1700,636,42,8,1,1,0,1012,629,268,72,27,7,5,4,3400,1195,1193,1012,4725,Census Tract 70.89,08,031,007089,Denver County
123,873,596,76,164,81,85,50,55,85,277,10,29,37,49,49,30,73,873,508,88,277,3637,Census Tract 83.04,08,031,008304,Denver County
124,910,573,81,118,70,86,69,55,94,337,25,32,36,65,78,38,63,910,494,79,337,3963,Census Tract 83.05,08,031,008305,Denver County
125,1618,816,146,265,121,97,69,54,64,802,162,124,141,147,103,64,61,1618,665,151,802,5451,Census Tract 83.06,08,031,008306,Denver County
126,1981,1149,198,273,181,179,147,72,99,832,223,105,135,148,89,56,76,1981,1078,71,832,6825,Census Tract 83.12,08,031,008312,Denver County
127,1077,774,102,156,117,143,107,57,92,303,13,39,39,50,54,41,67,1077,673,101,303,4511,Census Tract 83.86,08,031,008386,Denver County
128,1483,1149,145,252,156,211,166,88,131,334,20,25,44,75,78,39,53,1483,1102,47,334,5961,Census Tract 83.87,08,031,008387,Denver County
129,2535,1073,211,253,160,182,123,86,58,1462,521,410,242,163,78,29,19,2535,1041,32,1462,6962,Census Tract 83.88,08,031,008388,Denver County
130,2192,1939,255,464,392,408,230,102,88,253,22,25,37,68,53,24,24,2192,1908,31,253,7516,Census Tract 83.89,08,031,008389,Denver County
131,2499,1817,300,495,353,327,204,69,69,682,140,164,146,103,74,26,29,2499,1753,64,682,7703,Census Tract 83.90,08,031,008390,Denver County
132,2201,1821,332,474,327,343,195,88,62,380,38,69,71,87,61,31,23,2201,1769,52,380,7020,Census Tract 83.91,08,031,008391,Denver County
133,2758,1369,381,499,189,167,83,31,19,1389,461,412,218,175,81,25,17,2758,958,411,1389,6695,Census Tract 119.02,08,031,011902,Denver County
134,894,648,178,265,94,58,32,11,10,246,66,66,43,36,23,9,3,894,426,222,246,2194,Census Tract 119.03,08,031,011903,Denver County
135,955,705,190,363,72,52,15,11,2,250,100,76,34,24,12,2,2,955,456,249,250,2032,Census Tract 120.01,08,031,012001,Denver County
136,2395,1550,510,580,186,172,74,15,13,845,389,311,90,38,14,3,0,2395,1239,311,845,4995,Census Tract 120.10,08,031,012010,Denver County
137,2811,1767,611,584,268,197,73,26,8,1044,382,377,165,69,36,8,7,2811,1589,178,1044,6137,Census Tract 120.14,08,031,012014,Denver County
138,2339,569,225,223,72,33,8,5,3,1770,1148,431,106,55,19,7,4,2339,416,153,1770,3832,Census Tract 153,08,031,015300,Denver County
139,1586,1083,375,421,132,100,32,15,8,503,235,122,67,40,27,7,5,1586,853,230,503,3934,Census Tract 154,08,031,015400,Denver County
140,1647,169,58,62,28,13,7,1,0,1478,733,399,142,102,59,30,13,1647,133,36,1478,3313,Census Tract 155,08,031,015500,Denver County
141,2038,861,193,210,142,119,88,48,61,1177,261,278,201,171,122,74,70,2038,661,200,1177,6498,Census Tract 156,08,031,015600,Denver County
142,2059,1004,230,381,165,127,52,21,28,1055,370,254,158,130,82,39,22,2059,717,287,1055,5535,Census Tract 157,08,031,015700,Denver County
143,509,391,133,148,60,33,13,3,1,118,23,34,29,17,6,7,2,509,378,13,118,1165,Census Tract 9800,08,031,980000,Denver County
144,0,0,0,0,0,0,0,0,0,0,0,0,0,0,0,0,0,0,0,0,0,0,Census Tract 9801,08,031,980100,Denver County
1,899,727,199,325,85,71,30,12,5,172,68,31,29,25,16,2,1,899,336,391,172,2064,Census Tract 1,08,033,000100,Dolores County
1,2521,1795,203,698,358,339,128,48,21,726,328,239,79,47,22,6,5,2521,1452,343,726,6540,Census Tract 139.01,08,035,013901,Douglas County
2,1663,789,216,279,163,82,31,15,3,874,337,275,139,81,29,7,6,1663,709,80,874,3742,Census Tract 139.04,08,035,013904,Douglas County
3,1382,882,91,314,163,198,88,17,11,500,200,126,88,57,18,7,4,1382,810,72,500,3733,Census Tract 139.05,08,035,013905,Douglas County
4,1717,1434,315,440,273,272,99,22,13,283,78,66,54,47,26,7,5,1717,1328,106,283,4596,Census Tract 139.07,08,035,013907,Douglas County
5,2294,2172,231,1008,359,378,142,42,12,122,21,24,18,22,25,7,5,2294,1806,366,122,6306,Census Tract 139.08,08,035,013908,Douglas County
6,2099,1965,205,749,345,412,166,71,17,134,26,34,23,26,19,3,3,2099,1693,272,134,6169,Census Tract 139.09,08,035,013909,Douglas County
7,2021,1874,209,591,316,481,215,50,12,147,12,35,24,33,25,10,8,2021,1730,144,147,6263,Census Tract 139.10,08,035,013910,Douglas County
8,2043,1931,162,597,338,511,206,71,46,112,18,23,21,27,15,4,4,2043,1745,186,112,6586,Census Tract 139.11,08,035,013911,Douglas County
9,2518,2104,586,688,363,316,105,32,14,414,90,136,76,68,32,11,1,2518,2012,92,414,6242,Census Tract 140.01,08,035,014001,Douglas County
10,1649,1474,389,400,249,279,115,32,10,175,42,47,35,24,18,7,2,1649,1391,83,175,4382,Census Tract 140.05,08,035,014005,Douglas County
11,1670,1572,163,470,313,389,152,57,28,98,11,30,16,28,11,2,0,1670,1495,77,98,5205,Census Tract 140.06,08,035,014006,Douglas County
12,1221,311,93,107,49,32,15,5,10,910,452,305,89,42,17,4,1,1221,265,46,910,2410,Census Tract 140.07,08,035,014007,Douglas County
13,2095,2000,156,582,421,582,197,49,13,95,4,15,27,26,13,6,4,2095,1866,134,95,6637,Census Tract 140.08,08,035,014008,Douglas County
14,1119,1000,98,265,239,265,98,26,9,119,6,17,25,35,17,13,6,1119,955,45,119,3587,Census Tract 140.09,08,035,014009,Douglas County
15,2029,1224,154,328,244,334,114,32,18,805,333,244,112,69,32,13,2,2029,1146,78,805,5466,Census Tract 140.10,08,035,014010,Douglas County
16,826,276,38,99,43,68,17,9,2,550,313,159,53,20,2,1,2,826,265,11,550,1692,Census Tract 140.11,08,035,014011,Douglas County
17,2535,2005,222,629,378,478,211,62,25,530,185,165,80,62,22,8,8,2535,1837,168,530,7440,Census Tract 140.12,08,035,014012,Douglas County
18,1108,1048,54,314,194,268,157,35,26,60,6,12,11,15,12,4,0,1108,989,59,60,3742,Census Tract 140.13,08,035,014013,Douglas County
19,1303,1223,131,500,240,229,82,23,18,80,4,26,16,19,9,3,3,1303,1048,175,80,3718,Census Tract 141.07,08,035,014107,Douglas County
20,1775,1619,266,583,310,312,107,34,7,156,22,39,34,32,20,4,5,1775,1398,221,156,4894,Census Tract 141.08,08,035,014108,Douglas County
21,887,763,151,282,113,141,61,10,5,124,50,58,7,6,2,1,0,887,594,169,124,2259,Census Tract 141.09,08,035,014109,Douglas County
22,2224,1311,264,410,212,281,104,33,7,913,399,281,139,67,17,9,1,2224,1170,141,913,5406,Census Tract 141.10,08,035,014110,Douglas County
23,1408,1252,249,414,224,246,82,29,8,156,24,44,39,29,14,3,3,1408,1094,158,156,3834,Census Tract 141.12,08,035,014112,Douglas County
24,980,899,104,285,213,194,70,28,5,81,9,17,19,16,10,3,7,980,817,82,81,2930,Census Tract 141.13,08,035,014113,Douglas County
25,1335,912,155,302,172,162,74,29,18,423,176,127,55,33,18,9,5,1335,783,129,423,3517,Census Tract 141.14,08,035,014114,Douglas County
26,1636,1332,222,539,205,259,83,20,4,304,82,109,46,46,15,4,2,1636,1109,223,304,4249,Census Tract 141.15,08,035,014115,Douglas County
27,2064,661,86,220,101,161,79,12,2,1403,678,484,151,71,13,4,2,2064,561,100,1403,4440,Census Tract 141.16,08,035,014116,Douglas County
28,2391,1951,204,800,321,394,182,38,12,440,164,122,70,45,31,6,2,2391,1653,298,440,6572,Census Tract 141.22,08,035,014122,Douglas County
29,1215,573,117,285,61,69,36,5,0,642,247,172,112,58,39,7,7,1215,460,113,642,3087,Census Tract 141.23,08,035,014123,Douglas County
30,1723,1599,134,489,317,424,165,51,19,124,18,22,21,32,21,6,4,1723,1456,143,124,5456,Census Tract 141.24,08,035,014124,Douglas County
31,931,840,124,318,132,169,65,23,9,91,32,27,11,12,4,3,2,931,704,136,91,2579,Census Tract 141.25,08,035,014125,Douglas County
32,729,259,104,104,37,14,0,0,0,470,255,129,58,24,3,1,0,729,226,33,470,1283,Census Tract 141.26,08,035,014126,Douglas County
33,1704,1617,139,560,278,440,154,34,12,87,3,24,19,19,13,6,3,1704,1437,180,87,5220,Census Tract 141.27,08,035,014127,Douglas County
34,1743,1538,374,478,258,305,86,32,5,205,32,56,35,48,22,11,1,1743,1421,117,205,4611,Census Tract 141.28,08,035,014128,Douglas County
35,1208,1137,164,286,187,310,150,33,7,71,16,19,12,14,4,5,1,1208,1053,84,71,3740,Census Tract 141.29,08,035,014129,Douglas County
36,2390,2216,237,587,426,642,248,59,17,174,14,33,37,49,24,12,5,2390,2086,130,174,7591,Census Tract 141.30,08,035,014130,Douglas County
37,1616,748,194,295,81,116,48,13,1,868,451,300,68,39,7,3,0,1616,481,267,868,3283,Census Tract 141.31,08,035,014131,Douglas County
38,1683,1613,94,386,329,522,202,61,19,70,6,9,13,25,10,3,4,1683,1474,139,70,5726,Census Tract 141.32,08,035,014132,Douglas County
39,2111,1918,267,536,367,495,190,45,18,193,33,60,38,30,23,5,4,2111,1738,180,193,6346,Census Tract 141.33,08,035,014133,Douglas County
40,1905,1767,218,458,334,511,184,48,14,138,25,36,32,25,12,7,1,1905,1665,102,138,5897,Census Tract 141.34,08,035,014134,Douglas County
41,746,660,55,175,127,167,101,24,11,86,32,18,12,8,9,6,1,746,550,110,86,2412,Census Tract 141.35,08,035,014135,Douglas County
42,2902,2248,336,665,451,545,175,57,19,654,137,170,138,118,67,16,8,2902,2130,118,654,8411,Census Tract 141.36,08,035,014136,Douglas County
43,2853,2711,219,657,547,847,319,93,29,142,8,30,34,47,16,4,3,2853,2569,142,142,9410,Census Tract 141.37,08,035,014137,Douglas County
44,1622,435,196,179,40,15,5,0,0,1187,586,376,133,66,18,4,4,1622,379,56,1187,2902,Census Tract 141.38,08,035,014138,Douglas County
45,1534,1405,302,493,230,246,96,23,15,129,32,31,23,26,12,3,2,1534,1106,299,129,4052,Census Tract 141.39,08,035,014139,Douglas County
46,1739,1665,136,472,366,451,166,56,18,74,5,19,15,18,11,5,1,1739,1500,165,74,5531,Census Tract 141.40,08,035,014140,Douglas County
47,730,650,93,331,101,67,35,16,7,80,27,28,10,6,6,1,2,730,462,188,80,1845,Census Tract 142.02,08,035,014202,Douglas County
48,2163,2053,197,843,361,428,145,56,23,110,10,27,25,25,15,6,2,2163,1866,187,110,6272,Census Tract 142.03,08,035,014203,Douglas County
49,1098,982,131,313,204,229,74,25,6,116,20,25,33,27,7,3,1,1098,921,61,116,3188,Census Tract 142.04,08,035,014204,Douglas County
50,331,276,61,149,31,24,4,5,2,55,19,20,7,8,1,0,0,331,197,79,55,730,Census Tract 143,08,035,014300,Douglas County
51,1917,1621,184,772,270,247,87,37,24,296,99,89,39,38,23,8,0,1917,1300,321,296,5076,Census Tract 144.03,08,035,014403,Douglas County
52,949,883,120,501,125,93,27,17,0,66,18,15,12,13,4,1,3,949,699,184,66,2323,Census Tract 144.04,08,035,014404,Douglas County
53,2397,2187,207,593,430,608,253,67,29,210,13,45,41,50,40,14,7,2397,2058,129,210,7765,Census Tract 144.05,08,035,014405,Douglas County
54,2472,2174,281,689,430,495,192,72,15,298,42,66,68,79,30,9,4,2472,2043,131,298,7382,Census Tract 144.06,08,035,014406,Douglas County
55,2085,1499,238,550,271,269,119,41,11,586,202,154,105,67,35,17,6,2085,1365,134,586,5592,Census Tract 145.03,08,035,014503,Douglas County
56,1778,1095,194,447,188,158,73,29,6,683,222,162,116,106,53,17,7,1778,904,191,683,4647,Census Tract 145.04,08,035,014504,Douglas County
57,1753,1138,268,531,154,117,47,15,6,615,216,215,84,59,26,12,3,1753,970,168,615,4101,Census Tract 145.05,08,035,014505,Douglas County
58,1189,1100,85,496,183,206,74,43,13,89,20,24,11,19,7,6,2,1189,981,119,89,3435,Census Tract 145.06,08,035,014506,Douglas County
59,873,783,98,421,104,81,51,21,7,90,29,26,9,13,3,5,5,873,574,209,90,2254,Census Tract 146.02,08,035,014602,Douglas County
60,2168,1920,247,525,386,474,202,67,19,248,31,61,34,63,42,12,5,2168,1836,84,248,6739,Census Tract 146.03,08,035,014603,Douglas County
61,1248,1141,110,344,199,277,142,46,23,107,14,21,27,21,15,7,2,1248,1079,62,107,4022,Census Tract 146.04,08,035,014604,Douglas County
1,423,283,49,83,35,46,45,16,9,140,44,46,20,13,9,3,5,423,194,89,140,1245,Census Tract 1,08,037,000100,Eagle County
2,2115,1586,201,489,296,301,164,78,57,529,90,114,98,99,67,35,26,2115,1426,160,529,6764,Census Tract 2,08,037,000200,Eagle County
3,2003,1480,280,486,233,268,110,54,49,523,125,155,87,68,44,17,27,2003,1219,261,523,5800,Census Tract 3.01,08,037,000301,Eagle County
4,969,653,160,245,86,94,33,20,15,316,110,100,33,33,21,8,11,969,477,176,316,2467,Census Tract 3.02,08,037,000302,Eagle County
5,2096,1493,357,611,241,179,65,25,15,603,99,164,114,100,66,34,26,2096,1253,240,603,5530,Census Tract 4.01,08,037,000401,Eagle County
6,1437,1100,134,394,173,199,101,51,48,337,63,77,73,60,25,17,22,1437,810,290,337,4512,Census Tract 4.02,08,037,000402,Eagle County
7,2848,2007,249,703,376,469,153,32,25,841,215,214,154,117,82,36,23,2848,1766,241,841,8247,Census Tract 4.03,08,037,000403,Eagle County
8,466,260,63,151,23,14,5,3,1,206,76,71,29,27,0,0,3,466,159,101,206,977,Census Tract 5.01,08,037,000501,Eagle County
9,1255,740,163,299,108,121,36,9,4,515,104,141,135,88,33,9,5,1255,640,100,515,3231,Census Tract 5.02,08,037,000502,Eagle County
10,2319,1088,266,342,169,149,88,40,34,1231,285,364,218,177,105,46,36,2319,855,233,1231,6445,Census Tract 5.03,08,037,000503,Eagle County
11,585,317,78,122,56,37,17,3,4,268,93,79,37,39,15,4,1,585,222,95,268,1398,Census Tract 6,08,037,000600,Eagle County
12,575,287,90,98,53,38,7,1,0,288,92,97,60,31,6,2,0,575,209,78,288,1270,Census Tract 7.01,08,037,000701,Eagle County
13,771,442,156,208,32,32,6,6,2,329,151,115,40,18,1,4,0,771,267,175,329,1479,Census Tract 7.02,08,037,000702,Eagle County
14,1374,607,209,260,62,54,20,1,1,767,267,297,118,68,11,2,4,1374,425,182,767,2832,Census Tract 7.03,08,037,000703,Eagle County
1,792,593,125,278,62,71,30,20,7,199,67,50,32,20,23,6,1,792,377,216,199,2010,Census Tract 9611,08,039,961100,Elbert County
2,2289,2161,226,880,404,383,154,75,39,128,15,33,24,22,22,7,5,2289,1989,172,128,6687,Census Tract 9612.04,08,039,961204,Elbert County
3,693,590,109,292,77,57,37,9,9,103,36,31,13,13,6,1,3,693,438,152,103,1707,Census Tract 9612.05,08,039,961205,Elbert County
4,1245,1167,166,505,185,185,76,31,19,78,22,13,13,17,8,4,1,1245,1024,143,78,3412,Census Tract 9612.06,08,039,961206,Elbert County
5,1327,1161,142,506,207,178,71,36,21,166,42,38,33,19,21,6,7,1327,1001,160,166,3711,Census Tract 9612.07,08,039,961207,Elbert County
6,1183,999,152,427,166,142,75,20,17,184,53,44,29,28,22,3,5,1183,841,158,184,3208,Census Tract 9612.08,08,039,961208,Elbert County
7,851,711,112,296,125,105,43,19,11,140,30,38,26,25,12,7,2,851,573,138,140,2351,Census Tract 9612.09,08,039,961209,Elbert County
1,2867,1207,340,567,156,103,24,14,3,1660,853,440,215,98,37,14,3,2867,844,363,1660,5902,Census Tract 1.01,08,041,000101,El Paso County
2,1291,1121,291,498,162,96,48,19,7,170,18,36,36,39,15,19,7,1291,750,371,170,3169,Census Tract 1.02,08,041,000102,El Paso County
3,1876,1097,221,473,160,141,68,23,11,779,287,246,99,80,38,21,8,1876,802,295,779,4548,Census Tract 2.02,08,041,000202,El Paso County
4,1708,1065,309,415,163,123,31,17,7,643,247,195,102,51,29,10,9,1708,764,301,643,3855,Census Tract 2.03,08,041,000203,El Paso County
5,1383,804,295,302,96,69,25,9,8,579,246,159,91,45,24,11,3,1383,523,281,579,2997,Census Tract 3.01,08,041,000301,El Paso County
6,1746,903,449,287,78,51,28,8,2,843,363,224,121,76,39,13,7,1746,254,649,843,3789,Census Tract 3.02,08,041,000302,El Paso County
7,1073,716,262,269,102,50,17,12,4,357,155,78,59,35,21,6,3,1073,468,248,357,2285,Census Tract 4,08,041,000400,El Paso County
8,1012,710,287,266,95,46,12,4,0,302,124,103,46,20,5,1,3,1012,500,210,302,1973,Census Tract 5,08,041,000500,El Paso County
9,1263,945,272,390,135,79,49,9,11,318,81,91,56,48,24,12,6,1263,633,312,318,3013,Census Tract 6,08,041,000600,El Paso County
10,1417,800,269,313,78,74,39,15,12,617,268,149,73,77,30,9,11,1417,535,265,617,3182,Census Tract 7,08,041,000700,El Paso County
11,1323,633,223,257,89,45,12,5,2,690,334,211,72,48,14,7,4,1323,483,150,690,2613,Census Tract 8,08,041,000800,El Paso County
12,1139,723,255,263,106,66,23,9,1,416,216,104,49,31,12,3,1,1139,559,164,416,2337,Census Tract 9,08,041,000900,El Paso County
13,1060,736,186,327,94,79,36,8,6,324,203,76,25,11,4,4,1,1060,485,251,324,2303,Census Tract 10,08,041,001000,El Paso County
14,705,213,89,76,25,18,3,1,1,492,283,118,47,26,14,0,4,705,145,68,492,1286,Census Tract 11.01,08,041,001101,El Paso County
15,1460,689,221,259,107,47,36,14,5,771,320,244,97,67,31,10,2,1460,533,156,771,3156,Census Tract 11.04,08,041,001104,El Paso County
16,1113,558,191,214,91,46,14,1,1,555,278,157,66,36,13,1,4,1113,440,118,555,2276,Census Tract 13.01,08,041,001301,El Paso County
17,2410,1208,389,502,155,109,31,16,6,1202,506,380,171,80,42,11,12,2410,861,347,1202,5068,Census Tract 13.02,08,041,001302,El Paso County
18,1750,923,345,345,124,69,30,5,5,827,381,277,97,49,15,5,3,1750,704,219,827,3458,Census Tract 14,08,041,001400,El Paso County
19,1050,594,236,201,90,43,15,3,6,456,171,136,74,51,16,5,3,1050,481,113,456,2368,Census Tract 15,08,041,001500,El Paso County
20,1025,145,65,45,15,12,5,2,1,880,574,207,51,26,17,3,2,1025,114,31,880,3712,Census Tract 16,08,041,001600,El Paso County
21,826,345,137,127,35,31,11,3,1,481,252,129,57,33,9,1,0,826,288,57,481,1564,Census Tract 17,08,041,001700,El Paso County
22,1031,708,278,278,101,38,10,3,0,323,147,101,37,26,8,4,0,1031,521,187,323,1985,Census Tract 18,08,041,001800,El Paso County
23,2170,708,280,262,98,43,14,9,2,1462,759,388,161,75,50,16,13,2170,533,175,1462,4326,Census Tract 19,08,041,001900,El Paso County
24,2686,1414,392,529,204,155,81,32,21,1272,554,276,187,135,63,35,22,2686,1009,405,1272,6338,Census Tract 20,08,041,002000,El Paso County
25,1797,445,146,168,71,35,13,7,5,1352,725,349,154,72,29,13,10,1797,317,128,1352,3672,Census Tract 21.01,08,041,002101,El Paso County
26,1816,1043,277,370,160,108,59,40,29,773,233,180,121,107,84,33,15,1816,789,254,773,4820,Census Tract 21.02,08,041,002102,El Paso County
27,1352,543,220,187,56,48,25,6,1,809,417,207,95,44,23,14,9,1352,431,112,809,2737,Census Tract 22,08,041,002200,El Paso County
28,854,204,85,66,26,13,8,4,2,650,486,109,28,17,3,7,0,854,180,24,650,1546,Census Tract 23,08,041,002300,El Paso County
29,2432,1038,347,383,140,111,40,14,3,1394,878,317,108,60,18,11,2,2432,753,285,1394,4589,Census Tract 24,08,041,002400,El Paso County
30,1404,1225,237,555,190,175,53,13,2,179,80,46,26,17,8,2,0,1404,816,409,179,3345,Census Tract 25.01,08,041,002501,El Paso County
31,1974,817,244,312,128,97,29,4,3,1157,659,318,110,55,11,3,1,1974,576,241,1157,3804,Census Tract 25.02,08,041,002502,El Paso County
32,1467,649,253,240,79,44,15,11,7,818,430,218,83,47,23,8,9,1467,513,136,818,2997,Census Tract 27,08,041,002700,El Paso County
33,2467,1066,339,374,140,118,60,26,9,1401,636,336,198,134,65,19,13,2467,792,274,1401,5595,Census Tract 28,08,041,002800,El Paso County
34,2557,1070,378,356,167,101,37,18,13,1487,603,347,213,170,87,40,27,2557,812,258,1487,5902,Census Tract 29,08,041,002900,El Paso County
35,2368,847,306,343,108,57,29,4,0,1521,778,426,186,75,43,10,3,2368,626,221,1521,4555,Census Tract 30,08,041,003000,El Paso County
36,1860,1594,354,732,222,195,68,15,8,266,98,87,32,29,11,7,2,1860,1016,578,266,4423,Census Tract 31,08,041,003100,El Paso County
37,2389,1092,343,433,140,92,47,23,14,1297,531,373,199,106,60,20,8,2389,792,300,1297,5405,Census Tract 33.03,08,041,003303,El Paso County
38,2746,2115,341,956,360,306,117,30,5,631,275,202,81,46,26,0,1,2746,1644,471,631,6603,Census Tract 33.05,08,041,003305,El Paso County
39,1099,963,151,358,163,164,83,27,17,136,39,40,19,20,14,3,1,1099,766,197,136,3064,Census Tract 33.06,08,041,003306,El Paso County
40,1446,956,231,402,151,99,43,19,11,490,142,169,83,57,25,9,5,1446,791,165,490,3468,Census Tract 33.07,08,041,003307,El Paso County
41,2637,833,267,302,124,94,29,12,5,1804,599,622,336,165,51,20,11,2637,736,97,1804,5845,Census Tract 33.08,08,041,003308,El Paso County
42,1646,1223,303,575,160,118,43,15,9,423,205,114,42,30,16,10,6,1646,841,382,423,3703,Census Tract 34,08,041,003400,El Paso County
43,2782,2231,345,933,361,344,165,59,24,551,163,130,102,83,45,16,12,2782,1744,487,551,7513,Census Tract 37.01,08,041,003701,El Paso County
44,1934,1749,264,745,321,278,100,23,18,185,33,52,38,35,16,8,3,1934,1404,345,185,5273,Census Tract 37.02,08,041,003702,El Paso County
45,2234,1803,328,793,312,245,88,24,13,431,136,134,78,52,21,9,1,2234,1369,434,431,5533,Census Tract 37.05,08,041,003705,El Paso County
46,1682,1323,233,515,230,200,96,30,19,359,132,111,52,38,16,10,0,1682,1101,222,359,4359,Census Tract 37.06,08,041,003706,El Paso County
47,1588,1234,176,512,245,199,66,29,7,354,53,133,87,45,24,9,3,1588,1039,195,354,4242,Census Tract 37.07,08,041,003707,El Paso County
48,1284,850,200,325,151,117,37,17,3,434,201,133,57,27,10,5,1,1284,692,158,434,2914,Census Tract 37.08,08,041,003708,El Paso County
49,2610,1538,307,682,227,220,66,25,11,1072,529,290,147,67,26,9,4,2610,1241,297,1072,5971,Census Tract 37.09,08,041,003709,El Paso County
50,532,4,1,0,0,1,1,1,0,528,29,109,113,144,102,25,6,532,2,2,528,2196,Census Tract 38.01,08,041,003801,El Paso County
51,1,0,0,0,0,0,0,0,0,1,0,1,0,0,0,0,0,1,0,0,1,4486,Census Tract 38.02,08,041,003802,El Paso County
52,2986,2691,260,862,517,592,305,101,54,295,27,64,56,79,39,19,11,2986,2469,222,295,9493,Census Tract 39.02,08,041,003902,El Paso County
53,1548,846,176,380,126,98,43,15,8,702,308,211,74,56,34,12,7,1548,645,201,702,3548,Census Tract 39.05,08,041,003905,El Paso County
54,2404,1512,262,656,250,200,88,40,16,892,323,273,119,96,50,18,13,2404,1176,336,892,5985,Census Tract 39.06,08,041,003906,El Paso County
55,2419,2016,367,812,312,279,137,65,44,403,121,117,55,50,36,14,10,2419,1612,404,403,6535,Census Tract 39.09,08,041,003909,El Paso County
56,341,2,1,1,0,0,0,0,0,339,26,96,66,92,43,14,2,341,0,2,339,1487,Census Tract 40.08,08,041,004008,El Paso County
57,633,203,42,59,40,27,25,5,5,430,136,120,90,54,23,4,3,633,178,25,430,1602,Census Tract 40.09,08,041,004009,El Paso County
58,1787,1445,351,517,270,183,75,31,18,342,49,81,77,77,41,15,2,1787,1134,311,342,4691,Census Tract 41,08,041,004100,El Paso County
59,1432,1130,217,416,214,165,83,26,9,302,80,70,56,43,34,15,4,1432,897,233,302,3837,Census Tract 42,08,041,004200,El Paso County
60,2082,1689,280,584,322,246,144,74,39,393,66,79,74,70,54,36,14,2082,1447,242,393,6360,Census Tract 43,08,041,004300,El Paso County
61,2404,15,2,1,2,9,0,1,0,2389,118,446,645,728,312,115,25,2404,9,6,2389,8339,Census Tract 44.01,08,041,004401,El Paso County
62,45,0,0,0,0,0,0,0,0,45,3,3,15,12,11,1,0,45,0,0,45,5474,Census Tract 44.02,08,041,004402,El Paso County
63,297,4,0,2,0,0,1,1,0,293,10,23,44,69,91,39,17,297,3,1,293,1477,Census Tract 44.03,08,041,004403,El Paso County
64,1455,946,233,316,167,120,58,29,23,509,93,131,108,84,45,26,22,1455,628,318,509,6348,Census Tract 45.01,08,041,004501,El Paso County
65,1456,1154,136,375,244,226,102,44,27,302,80,71,52,52,30,7,10,1456,1032,122,302,4366,Census Tract 45.02,08,041,004502,El Paso County
66,3893,3065,389,896,674,614,315,115,62,828,78,189,186,204,96,51,24,3893,2801,264,828,12193,Census Tract 45.03,08,041,004503,El Paso County
67,1683,1298,284,490,205,160,94,40,25,385,54,65,88,69,52,35,22,1683,884,414,385,4780,Census Tract 45.06,08,041,004506,El Paso County
68,1063,894,154,326,189,115,53,33,24,169,14,35,35,31,31,15,8,1063,668,226,169,3096,Census Tract 45.07,08,041,004507,El Paso County
69,2416,1416,273,477,266,207,132,40,21,1000,308,242,183,148,82,21,16,2416,1150,266,1000,6507,Census Tract 45.08,08,041,004508,El Paso County
70,2412,1966,228,532,444,461,185,84,32,446,69,95,109,96,47,22,8,2412,1878,88,446,7545,Census Tract 45.10,08,041,004510,El Paso County
71,2349,1836,267,603,381,334,152,68,31,513,104,121,111,92,44,29,12,2349,1650,186,513,6897,Census Tract 45.11,08,041,004511,El Paso County
72,1487,1275,218,472,215,208,103,46,13,212,44,63,42,30,17,10,6,1487,1111,164,212,4149,Census Tract 46.01,08,041,004601,El Paso County
73,1541,1185,236,444,205,146,82,42,30,356,71,108,55,49,41,22,10,1541,887,298,356,4289,Census Tract 46.02,08,041,004602,El Paso County
74,1394,1154,154,396,251,206,95,32,20,240,37,54,56,58,24,8,3,1394,981,173,240,4079,Census Tract 46.03,08,041,004603,El Paso County
75,1789,1291,263,523,226,161,81,24,13,498,120,132,98,69,46,23,10,1789,1049,242,498,4680,Census Tract 47.01,08,041,004701,El Paso County
76,819,519,75,181,101,94,45,13,10,300,111,98,35,32,17,7,0,819,483,36,300,2162,Census Tract 47.02,08,041,004702,El Paso County
77,2324,1662,276,643,289,259,126,44,25,662,233,174,98,68,59,20,10,2324,1471,191,662,6182,Census Tract 47.03,08,041,004703,El Paso County
78,2832,1901,356,592,360,384,128,56,25,931,273,263,149,148,59,29,10,2832,1758,143,931,7706,Census Tract 47.05,08,041,004705,El Paso County
79,1669,1439,220,449,249,341,115,48,17,230,29,53,48,45,33,13,9,1669,1332,107,230,4994,Census Tract 47.06,08,041,004706,El Paso County
80,1851,1077,206,432,197,136,75,25,6,774,260,208,126,89,52,31,8,1851,828,249,774,4693,Census Tract 48,08,041,004800,El Paso County
81,1471,807,189,326,114,105,36,24,13,664,229,194,110,70,36,13,12,1471,616,191,664,3601,Census Tract 49.01,08,041,004901,El Paso County
82,1981,1622,206,703,289,275,98,25,26,359,95,115,63,47,22,9,8,1981,1293,329,359,5367,Census Tract 49.02,08,041,004902,El Paso County
83,1967,978,211,347,186,141,60,21,12,989,288,263,176,143,79,29,11,1967,809,169,989,5150,Census Tract 50,08,041,005000,El Paso County
84,2153,1838,286,636,322,352,152,57,33,315,57,83,47,68,35,15,10,2153,1609,229,315,6259,Census Tract 51.04,08,041,005104,El Paso County
85,2283,1621,203,394,363,382,166,77,36,662,125,163,150,111,69,28,16,2283,1559,62,662,7154,Census Tract 51.05,08,041,005105,El Paso County
86,3483,2639,492,772,533,525,217,58,42,844,211,253,150,144,60,19,7,3483,2516,123,844,9712,Census Tract 51.06,08,041,005106,El Paso County
87,2343,1949,272,636,402,396,157,50,36,394,53,87,89,97,37,25,6,2343,1852,97,394,6963,Census Tract 51.07,08,041,005107,El Paso County
88,2807,2290,320,721,491,473,194,68,23,517,54,133,119,108,61,30,12,2807,2137,153,517,8377,Census Tract 51.08,08,041,005108,El Paso County
89,2731,2265,508,792,371,355,166,49,24,466,82,140,89,92,35,13,15,2731,2004,261,466,7285,Census Tract 51.09,08,041,005109,El Paso County
90,1504,974,190,320,207,150,74,21,12,530,110,165,111,88,38,15,3,1504,882,92,530,4070,Census Tract 51.10,08,041,005110,El Paso County
91,2267,1810,340,507,351,361,166,56,29,457,78,132,93,95,38,11,10,2267,1567,243,457,6571,Census Tract 51.11,08,041,005111,El Paso County
92,1737,363,94,130,46,33,40,10,10,1374,552,320,193,151,86,58,14,1737,253,110,1374,4328,Census Tract 52.01,08,041,005201,El Paso County
93,1281,594,337,176,37,29,9,3,3,687,267,202,124,60,25,7,2,1281,391,203,687,2466,Census Tract 52.02,08,041,005202,El Paso County
94,1636,904,233,313,162,100,57,18,21,732,201,175,132,101,68,30,25,1636,774,130,732,4478,Census Tract 53,08,041,005300,El Paso County
95,2007,935,187,303,140,135,89,51,30,1072,352,221,198,138,94,40,29,2007,719,216,1072,5615,Census Tract 54,08,041,005400,El Paso County
96,1715,1097,185,428,219,166,60,29,10,618,210,191,89,70,39,13,6,1715,923,174,618,4366,Census Tract 55.01,08,041,005501,El Paso County
97,1775,724,150,256,135,101,41,24,17,1051,441,234,157,127,61,17,14,1775,598,126,1051,4369,Census Tract 55.02,08,041,005502,El Paso County
98,1967,1416,359,579,228,138,78,21,13,551,134,150,111,90,36,19,11,1967,1126,290,551,4881,Census Tract 56.01,08,041,005601,El Paso County
99,1278,978,288,405,130,96,32,17,10,300,74,67,50,62,30,13,4,1278,811,167,300,3076,Census Tract 56.02,08,041,005602,El Paso County
100,2403,1536,333,694,217,180,68,31,13,867,373,199,138,92,36,22,7,2403,1083,453,867,5636,Census Tract 57,08,041,005700,El Paso County
101,1192,979,256,430,125,106,36,16,10,213,43,54,39,35,27,6,9,1192,680,299,213,2933,Census Tract 58,08,041,005800,El Paso County
102,2674,1848,423,813,274,204,83,35,16,826,256,248,103,102,73,28,16,2674,1345,503,826,6573,Census Tract 59,08,041,005900,El Paso County
103,2452,1240,315,478,215,104,85,23,20,1212,441,274,178,138,90,49,42,2452,814,426,1212,6188,Census Tract 60,08,041,006000,El Paso County
104,1517,340,69,115,66,42,29,8,11,1177,340,222,185,191,128,58,53,1517,273,67,1177,4454,Census Tract 61,08,041,006100,El Paso County
105,1911,989,329,327,128,87,62,34,22,922,327,244,124,115,64,35,13,1911,652,337,922,4669,Census Tract 62,08,041,006200,El Paso County
106,1567,1270,203,413,270,202,118,45,19,297,29,70,61,70,48,10,9,1567,1171,99,297,4664,Census Tract 63.01,08,041,006301,El Paso County
107,2052,466,86,140,95,77,37,23,8,1586,566,422,282,179,80,34,23,2052,439,27,1586,5106,Census Tract 63.02,08,041,006302,El Paso County
108,2429,1336,295,420,249,194,91,48,39,1093,234,253,255,171,95,47,38,2429,1167,169,1093,6932,Census Tract 64,08,041,006400,El Paso County
109,1111,847,187,265,141,120,80,31,23,264,37,50,54,54,36,14,19,1111,658,189,264,3299,Census Tract 65.01,08,041,006501,El Paso County
110,2115,1599,285,515,294,276,141,54,34,516,59,99,130,109,73,30,16,2115,1372,227,516,6349,Census Tract 65.02,08,041,006502,El Paso County
111,1166,841,230,380,107,84,22,13,5,325,135,115,37,18,14,5,1,1166,529,312,325,2539,Census Tract 66,08,041,006600,El Paso County
112,2829,1563,442,694,236,139,31,15,6,1266,674,354,135,64,23,10,6,2829,1068,495,1266,5728,Census Tract 67,08,041,006700,El Paso County
113,1702,993,241,353,184,142,45,14,14,709,281,205,101,68,37,14,3,1702,879,114,709,4032,Census Tract 68.01,08,041,006801,El Paso County
114,1367,1084,193,354,205,205,92,24,11,283,50,71,67,58,27,4,6,1367,953,131,283,3849,Census Tract 68.02,08,041,006802,El Paso County
115,1707,1439,164,366,314,374,147,55,19,268,16,46,76,69,41,12,8,1707,1333,106,268,5494,Census Tract 69.01,08,041,006901,El Paso County
116,1690,1094,160,332,226,228,95,37,16,596,138,154,118,98,57,24,7,1690,985,109,596,4910,Census Tract 69.02,08,041,006902,El Paso County
117,1521,1128,71,383,237,256,117,39,25,393,156,117,45,44,23,7,1,1521,974,154,393,4455,Census Tract 70,08,041,007000,El Paso County
118,1479,1048,75,240,202,329,141,44,17,431,167,123,46,57,21,12,5,1479,999,49,431,4565,Census Tract 71.01,08,041,007101,El Paso County
119,2843,2512,181,722,505,651,310,106,37,331,37,40,65,87,55,30,17,2843,2281,231,331,9449,Census Tract 71.02,08,041,007102,El Paso County
120,2371,1416,110,426,249,360,184,57,30,955,471,262,88,75,36,15,8,2371,1320,96,955,6559,Census Tract 72.01,08,041,007201,El Paso County
121,3164,2624,289,998,429,520,248,92,48,540,148,137,77,90,50,25,13,3164,2184,440,540,9317,Census Tract 72.02,08,041,007202,El Paso County
122,3100,2724,273,1034,462,586,246,92,31,376,86,88,63,71,30,23,15,3100,2359,365,376,9227,Census Tract 73,08,041,007300,El Paso County
123,2770,2645,233,1152,431,517,191,78,43,125,17,27,15,33,14,12,7,2770,2163,482,125,8095,Census Tract 74,08,041,007400,El Paso County
124,2713,2463,291,1053,405,422,162,83,47,250,56,58,50,45,29,7,5,2713,1995,468,250,7717,Census Tract 75,08,041,007500,El Paso County
125,2117,1978,203,802,357,322,192,60,42,139,27,31,18,22,23,7,11,2117,1727,251,139,6301,Census Tract 76.01,08,041,007601,El Paso County
126,1271,1167,153,529,188,182,70,26,19,104,22,22,19,22,11,4,4,1271,910,257,104,3484,Census Tract 76.02,08,041,007602,El Paso County
127,2557,1410,379,720,152,96,37,14,12,1147,479,359,153,93,39,14,10,2557,1024,386,1147,5413,Census Tract 77,08,041,007700,El Paso County
128,1629,990,194,464,152,106,47,15,12,639,329,189,65,33,15,6,2,1629,788,202,639,4470,Census Tract 78,08,041,007800,El Paso County
129,1128,1004,397,425,76,72,20,9,5,124,56,38,15,5,4,5,1,1128,624,380,124,2216,Census Tract 79,08,041,007900,El Paso County
130,1873,865,231,372,136,76,39,7,4,1008,421,334,123,89,28,10,3,1873,652,213,1008,3995,Census Tract 80,08,041,008000,El Paso County
1,1764,1476,295,690,211,153,75,33,19,288,81,86,51,36,24,4,6,1764,1025,451,288,4385,Census Tract 9781,08,043,978100,Fremont County
2,1676,1141,292,486,155,119,54,20,15,535,209,148,74,61,22,12,9,1676,762,379,535,3944,Census Tract 9782,08,043,978200,Fremont County
3,2354,1790,491,762,238,179,81,29,10,564,183,166,81,66,39,17,12,2354,1044,746,564,5626,Census Tract 9783,08,043,978300,Fremont County
4,897,619,178,288,63,53,26,5,6,278,111,76,46,25,15,4,1,897,371,248,278,2150,Census Tract 9784,08,043,978400,Fremont County
5,2437,1571,417,644,213,167,87,29,14,866,409,195,114,85,39,18,6,2437,1064,507,866,5902,Census Tract 9785,08,043,978500,Fremont County
6,1469,832,274,329,112,58,40,11,8,637,311,159,81,53,21,7,5,1469,620,212,637,3101,Census Tract 9786,08,043,978600,Fremont County
7,1145,821,272,342,87,75,29,14,2,324,124,89,55,31,18,3,4,1145,515,306,324,2490,Census Tract 9788,08,043,978800,Fremont County
8,1649,1442,355,803,148,85,32,15,4,207,81,74,25,15,9,2,1,1649,888,554,207,3462,Census Tract 9790,08,043,979000,Fremont County
9,1450,1182,305,551,140,113,51,17,5,268,104,64,40,25,20,11,4,1450,654,528,268,3342,Census Tract 9791,08,043,979100,Fremont County
10,715,651,81,391,75,69,22,7,6,64,15,14,10,12,8,3,2,715,463,188,64,1754,Census Tract 9792,08,043,979200,Fremont County
11,1026,896,196,391,136,77,54,27,15,130,30,31,24,17,15,11,2,1026,614,282,130,2722,Census Tract 9794,08,043,979400,Fremont County
12,0,0,0,0,0,0,0,0,0,0,0,0,0,0,0,0,0,0,0,0,0,945,Census Tract 9801,08,043,980100,Fremont County
13,0,0,0,0,0,0,0,0,0,0,0,0,0,0,0,0,0,0,0,0,0,3085,Census Tract 9802,08,043,980200,Fremont County
14,0,0,0,0,0,0,0,0,0,0,0,0,0,0,0,0,0,0,0,0,0,3916,Census Tract 9803,08,043,980300,Fremont County
1,1425,893,171,396,124,115,50,25,12,532,132,111,99,85,48,38,19,1425,634,259,532,3912,Census Tract 9516,08,045,951600,Garfield County
2,1549,1007,224,370,152,152,73,21,15,542,150,136,103,80,39,16,18,1549,811,196,542,4136,Census Tract 9517.01,08,045,951701,Garfield County
3,1492,618,173,233,91,79,22,13,7,874,413,212,96,80,46,13,14,1492,449,169,874,3526,Census Tract 9517.02,08,045,951702,Garfield County
4,1291,1015,140,452,149,163,69,23,19,276,72,71,51,42,20,11,9,1291,778,237,276,3564,Census Tract 9518.02,08,045,951802,Garfield County
5,2024,1152,221,487,167,170,59,21,27,872,225,215,138,134,65,41,54,2024,946,206,872,5934,Census Tract 9518.03,08,045,951803,Garfield County
6,1573,1135,240,457,177,165,60,19,17,438,147,101,57,55,33,21,24,1573,861,274,438,4202,Census Tract 9518.04,08,045,951804,Garfield County
7,1686,1300,200,501,221,213,100,32,33,386,103,97,81,42,33,19,11,1686,1062,238,386,4741,Census Tract 9519.01,08,045,951901,Garfield County
8,2519,1899,311,716,345,304,131,51,41,620,111,164,139,113,59,24,10,2519,1529,370,620,7097,Census Tract 9519.02,08,045,951902,Garfield County
9,1751,1118,177,347,202,192,128,37,35,633,164,155,126,92,47,30,19,1751,886,232,633,5161,Census Tract 9520.01,08,045,952001,Garfield County
10,2790,1752,299,634,286,286,150,53,44,1038,342,243,158,128,94,45,28,2790,1401,351,1038,8075,Census Tract 9520.02,08,045,952002,Garfield County
11,2259,1528,323,626,217,207,94,41,20,731,196,180,115,102,66,48,24,2259,1156,372,731,6041,Census Tract 9521,08,045,952100,Garfield County
1,2460,1894,487,879,261,180,55,25,7,566,226,191,80,42,16,8,3,2460,1524,370,566,5441,Census Tract 138,08,047,013800,Gilpin County
1,1240,868,227,347,109,125,42,12,6,372,158,98,47,33,20,9,7,1240,596,272,372,2911,Census Tract 1,08,049,000100,Grand County
2,2159,1548,364,801,182,135,53,9,4,611,249,156,83,66,30,15,12,2159,1069,479,611,4817,Census Tract 2.01,08,049,000201,Grand County
3,3070,2041,507,917,269,246,75,16,11,1029,394,329,163,85,37,9,12,3070,1510,531,1029,7115,Census Tract 2.02,08,049,000202,Grand County
1,1628,1274,306,571,181,136,56,14,10,354,123,123,42,42,21,2,1,1628,858,416,354,3794,Census Tract 9636,08,051,963600,Gunnison County
2,2446,1032,294,400,159,128,39,8,4,1414,559,449,188,137,54,22,5,2446,716,316,1414,6124,Census Tract 9637,08,051,963700,Gunnison County
3,2052,1286,315,536,201,199,27,3,5,766,288,299,110,45,19,4,1,2052,995,291,766,4501,Census Tract 9638,08,051,963800,Gunnison County
4,390,308,69,166,29,26,11,5,2,82,35,28,10,7,0,2,0,390,201,107,82,905,Census Tract 9639,08,051,963900,Gunnison County
1,362,251,61,131,29,25,5,0,0,111,40,38,10,16,2,4,1,362,158,93,111,843,Census Tract 9731,08,053,973100,Hinsdale County
1,1511,960,366,366,99,67,37,18,7,551,248,126,69,61,30,13,4,1511,488,472,551,3273,Census Tract 9606,08,055,960600,Huerfano County
2,1626,1278,376,669,114,72,34,10,3,348,169,84,38,28,14,10,5,1626,727,551,348,3438,Census Tract 9609,08,055,960900,Huerfano County
1,649,430,130,212,32,35,11,8,2,219,86,59,32,30,9,2,1,649,181,249,219,1394,Census Tract 9556,08,057,955600,Jackson County
1,1410,1333,253,587,208,201,57,19,8,77,16,18,13,20,9,1,0,1410,879,454,77,3541,Census Tract 98.06,08,059,009806,Jefferson County
2,762,531,153,211,76,62,23,4,2,231,133,49,28,15,4,2,0,762,367,164,231,1611,Census Tract 98.07,08,059,009807,Jefferson County
3,2468,1798,356,817,273,256,71,16,9,670,295,196,93,54,22,6,4,2468,1396,402,670,5714,Census Tract 98.08,08,059,009808,Jefferson County
4,1856,1668,278,623,314,319,100,27,7,188,46,49,39,37,12,5,0,1856,1390,278,188,4956,Census Tract 98.15,08,059,009815,Jefferson County
5,1680,1466,272,528,299,237,83,29,18,214,15,54,46,46,24,19,10,1680,1316,150,214,4659,Census Tract 98.23,08,059,009823,Jefferson County
6,1796,1538,251,542,323,275,98,36,13,258,32,64,58,60,26,11,7,1796,1415,123,258,5028,Census Tract 98.24,08,059,009824,Jefferson County
7,2387,1570,232,511,343,333,97,39,15,817,307,289,104,77,25,11,4,2387,1426,144,817,6180,Census Tract 98.27,08,059,009827,Jefferson County
8,2115,1671,343,613,302,269,101,27,16,444,175,152,46,38,20,6,7,2115,1428,243,444,5344,Census Tract 98.28,08,059,009828,Jefferson County
9,657,605,84,199,145,129,36,11,1,52,6,12,10,12,11,0,1,657,560,45,52,1857,Census Tract 98.29,08,059,009829,Jefferson County
10,972,782,338,248,92,72,19,11,2,190,47,62,39,30,10,2,0,972,653,129,190,2046,Census Tract 98.30,08,059,009830,Jefferson County
11,1217,5,3,1,1,0,0,0,0,1212,551,447,141,56,13,3,1,1217,5,0,1212,2190,Census Tract 98.31,08,059,009831,Jefferson County
12,942,771,176,277,133,107,49,17,12,171,36,54,31,21,16,8,5,942,620,151,171,2501,Census Tract 98.32,08,059,009832,Jefferson County
13,2325,1555,433,579,259,179,62,30,13,770,247,216,138,98,43,21,7,2325,1216,339,770,5555,Census Tract 98.33,08,059,009833,Jefferson County
14,1992,1469,553,492,214,124,58,16,12,523,180,172,89,58,16,7,1,1992,1173,296,523,4307,Census Tract 98.34,08,059,009834,Jefferson County
15,1397,1300,246,538,229,188,69,22,8,97,11,42,18,13,9,1,3,1397,1021,279,97,3575,Census Tract 98.35,08,059,009835,Jefferson County
16,1372,1283,142,541,253,227,76,28,16,89,28,24,18,6,7,2,4,1372,1005,278,89,3796,Census Tract 98.36,08,059,009836,Jefferson County
17,933,897,68,369,163,194,66,27,10,36,5,13,9,5,2,1,1,933,698,199,36,2750,Census Tract 98.37,08,059,009837,Jefferson County
18,1578,1525,209,610,262,300,98,37,9,53,8,17,4,16,4,2,2,1578,1281,244,53,4360,Census Tract 98.38,08,059,009838,Jefferson County
19,831,788,91,261,165,184,69,14,4,43,1,6,8,13,9,3,3,831,665,123,43,2484,Census Tract 98.39,08,059,009839,Jefferson County
20,1505,1105,236,440,193,152,53,19,12,400,251,55,35,24,19,11,5,1505,871,234,400,3685,Census Tract 98.40,08,059,009840,Jefferson County
21,836,758,126,341,108,102,59,13,9,78,15,24,15,11,9,2,2,836,566,192,78,2201,Census Tract 98.41,08,059,009841,Jefferson County
22,1055,990,134,386,163,195,79,25,8,65,18,16,16,12,2,1,0,1055,806,184,65,2942,Census Tract 98.42,08,059,009842,Jefferson County
23,2978,2345,424,898,402,457,125,32,7,633,291,196,65,41,34,6,0,2978,1875,470,633,7375,Census Tract 98.43,08,059,009843,Jefferson County
24,1724,1578,302,806,206,195,53,14,2,146,47,51,21,18,4,5,0,1724,1183,395,146,4010,Census Tract 98.45,08,059,009845,Jefferson County
25,1857,1596,269,658,227,291,117,27,7,261,116,66,34,28,7,10,0,1857,1175,421,261,4786,Census Tract 98.46,08,059,009846,Jefferson County
26,1282,1044,199,436,155,164,69,17,4,238,60,74,52,32,13,5,2,1282,829,215,238,3269,Census Tract 98.47,08,059,009847,Jefferson County
27,1030,784,115,360,109,134,52,11,3,246,175,42,17,8,2,2,0,1030,601,183,246,2519,Census Tract 98.48,08,059,009848,Jefferson County
28,2313,1576,384,627,249,219,72,16,9,737,218,231,162,95,21,9,1,2313,1045,531,737,5718,Census Tract 98.49,08,059,009849,Jefferson County
29,1046,922,159,446,133,129,39,15,1,124,44,39,12,18,10,1,0,1046,646,276,124,2553,Census Tract 98.50,08,059,009850,Jefferson County
30,1505,1399,306,543,201,233,85,19,12,106,19,28,25,19,7,7,1,1505,1098,301,106,3908,Census Tract 98.51,08,059,009851,Jefferson County
31,1396,1275,218,579,212,177,64,16,9,121,34,41,21,13,4,3,5,1396,947,328,121,3528,Census Tract 98.52,08,059,009852,Jefferson County
32,1113,581,133,261,99,59,24,2,3,532,246,145,67,51,14,7,2,1113,415,166,532,2451,Census Tract 99,08,059,009900,Jefferson County
33,1253,436,122,195,66,43,7,3,0,817,394,253,99,49,10,8,4,1253,283,153,817,4535,Census Tract 100,08,059,010000,Jefferson County
34,1986,831,297,282,125,75,39,6,7,1155,496,340,148,108,47,11,5,1986,530,301,1155,4360,Census Tract 101,08,059,010100,Jefferson County
35,904,808,117,362,134,132,40,11,12,96,56,16,6,9,2,5,2,904,557,251,96,2326,Census Tract 102.05,08,059,010205,Jefferson County
36,1600,1239,250,498,236,170,57,15,13,361,136,106,55,32,25,3,4,1600,976,263,361,3942,Census Tract 102.06,08,059,010206,Jefferson County
37,2120,1728,351,677,306,224,114,35,21,392,75,91,75,73,43,17,18,2120,1339,389,392,5707,Census Tract 102.08,08,059,010208,Jefferson County
38,2436,1751,435,640,297,232,82,37,28,685,216,185,113,84,56,13,18,2436,1501,250,685,6152,Census Tract 102.09,08,059,010209,Jefferson County
39,1386,1087,182,506,196,129,48,13,13,299,120,69,31,42,22,8,7,1386,762,325,299,3460,Census Tract 102.10,08,059,010210,Jefferson County
40,1381,726,162,311,107,84,41,13,8,655,414,87,75,39,25,10,5,1381,507,219,655,3093,Census Tract 102.11,08,059,010211,Jefferson County
41,1731,1090,266,406,186,148,52,19,13,641,177,171,109,103,44,24,13,1731,830,260,641,4481,Census Tract 102.12,08,059,010212,Jefferson County
42,1832,1328,333,486,203,154,79,41,32,504,199,90,80,52,39,27,17,1832,1015,313,504,4786,Census Tract 102.13,08,059,010213,Jefferson County
43,2182,1586,350,670,244,203,64,37,18,596,199,172,110,62,37,9,7,2182,1127,459,596,5333,Census Tract 103.03,08,059,010303,Jefferson County
44,1114,823,171,323,147,99,51,20,12,291,129,54,31,37,29,7,4,1114,556,267,291,2819,Census Tract 103.04,08,059,010304,Jefferson County
45,1573,899,290,317,147,96,32,10,7,674,245,170,114,82,43,12,8,1573,690,209,674,3641,Census Tract 103.05,08,059,010305,Jefferson County
46,1083,776,160,331,144,88,39,12,2,307,75,87,61,43,20,12,9,1083,540,236,307,2750,Census Tract 103.06,08,059,010306,Jefferson County
47,1999,850,226,301,129,116,54,16,8,1149,486,332,146,105,43,25,12,1999,651,199,1149,4579,Census Tract 103.07,08,059,010307,Jefferson County
48,2271,1651,465,585,253,229,81,27,11,620,211,190,95,78,28,14,4,2271,1330,321,620,5426,Census Tract 103.08,08,059,010308,Jefferson County
49,2408,1032,448,371,105,75,23,4,6,1376,552,417,208,124,53,16,6,2408,838,194,1376,5080,Census Tract 104.02,08,059,010402,Jefferson County
50,2481,905,367,317,117,66,23,8,7,1576,628,452,239,156,63,21,17,2481,721,184,1576,5279,Census Tract 104.03,08,059,010403,Jefferson County
51,1441,196,110,64,14,5,3,0,0,1245,670,362,119,57,23,6,8,1441,173,23,1245,2514,Census Tract 104.05,08,059,010405,Jefferson County
52,941,584,184,192,86,63,33,17,9,357,104,98,51,51,26,12,15,941,403,181,357,2428,Census Tract 104.06,08,059,010406,Jefferson County
53,2258,1508,428,661,214,136,44,17,8,750,282,220,101,72,52,14,9,2258,988,520,750,5100,Census Tract 105.02,08,059,010502,Jefferson County
54,1977,1296,317,573,186,134,60,23,3,681,285,200,91,69,31,3,2,1977,881,415,681,4462,Census Tract 105.03,08,059,010503,Jefferson County
55,1256,1090,246,490,160,140,43,7,4,166,114,19,14,10,7,0,2,1256,676,414,166,2835,Census Tract 105.04,08,059,010504,Jefferson County
56,1510,875,340,328,103,58,30,9,7,635,299,171,88,50,16,10,1,1510,637,238,635,3137,Census Tract 106.03,08,059,010603,Jefferson County
57,1043,652,217,245,89,58,26,8,9,391,162,111,44,44,21,4,5,1043,487,165,391,2310,Census Tract 106.04,08,059,010604,Jefferson County
58,1974,1020,341,406,156,79,19,10,9,954,563,224,84,45,19,10,9,1974,700,320,954,3905,Census Tract 107.01,08,059,010701,Jefferson County
59,2258,882,326,328,115,75,20,11,7,1376,565,348,207,143,62,30,21,2258,676,206,1376,5060,Census Tract 107.02,08,059,010702,Jefferson County
60,1092,912,250,396,128,105,23,7,3,180,54,40,44,19,17,3,3,1092,565,347,180,2497,Census Tract 108.01,08,059,010801,Jefferson County
61,2009,1261,295,564,203,129,46,15,9,748,244,207,130,90,42,20,15,2009,943,318,748,4793,Census Tract 109.01,08,059,010901,Jefferson County
62,1077,336,109,105,63,34,16,4,5,741,353,200,79,59,27,13,10,1077,260,76,741,2310,Census Tract 109.02,08,059,010902,Jefferson County
63,2279,1246,380,501,172,120,40,24,9,1033,387,283,160,107,56,25,15,2279,898,348,1033,5500,Census Tract 110,08,059,011000,Jefferson County
64,2676,1181,366,473,160,118,37,14,13,1495,581,405,221,153,96,22,17,2676,840,341,1495,6135,Census Tract 111,08,059,011100,Jefferson County
65,1706,1328,363,547,182,155,47,22,12,378,116,96,66,50,31,14,5,1706,918,410,378,4567,Census Tract 112.02,08,059,011202,Jefferson County
66,1439,879,300,351,131,55,26,7,9,560,230,156,71,52,29,17,5,1439,701,178,560,3115,Census Tract 113,08,059,011300,Jefferson County
67,1122,387,150,113,46,35,18,14,11,735,289,175,121,73,44,17,16,1122,285,102,735,2822,Census Tract 114.01,08,059,011401,Jefferson County
68,1774,500,241,158,56,29,12,0,4,1274,581,331,167,118,56,14,7,1774,391,109,1274,3839,Census Tract 114.02,08,059,011402,Jefferson County
69,2692,980,357,355,121,81,37,19,10,1712,727,385,233,193,102,41,31,2692,754,226,1712,6198,Census Tract 115.50,08,059,011550,Jefferson County
70,1341,685,190,254,102,77,29,18,15,656,120,153,122,131,69,36,25,1341,508,177,656,4021,Census Tract 116.01,08,059,011601,Jefferson County
71,1512,903,278,338,111,78,52,27,19,609,142,133,123,98,69,23,21,1512,673,230,609,4006,Census Tract 116.02,08,059,011602,Jefferson County
72,1948,1499,435,612,197,166,67,13,9,449,192,117,66,41,21,7,5,1948,1078,421,449,4376,Census Tract 117.01,08,059,011701,Jefferson County
73,2199,1759,455,707,258,208,79,31,21,440,172,103,67,46,38,4,10,2199,1271,488,440,5382,Census Tract 117.02,08,059,011702,Jefferson County
74,1607,1369,300,589,225,142,78,25,10,238,41,62,50,42,26,10,7,1607,953,416,238,4074,Census Tract 117.08,08,059,011708,Jefferson County
75,1464,954,266,382,147,100,41,9,9,510,177,145,101,56,19,9,3,1464,729,225,510,3362,Census Tract 117.09,08,059,011709,Jefferson County
76,1804,1104,298,422,179,142,34,16,13,700,330,227,67,54,15,6,1,1804,812,292,700,3937,Census Tract 117.10,08,059,011710,Jefferson County
77,1781,1213,324,504,166,143,55,15,6,568,242,167,66,57,23,9,4,1781,856,357,568,4017,Census Tract 117.11,08,059,011711,Jefferson County
78,1760,1591,401,705,236,172,54,15,8,169,43,58,31,23,9,2,3,1760,1122,469,169,4061,Census Tract 117.12,08,059,011712,Jefferson County
79,2037,1725,280,748,307,262,92,26,10,312,102,97,54,31,16,8,4,2037,1299,426,312,5177,Census Tract 117.20,08,059,011720,Jefferson County
80,1206,829,161,356,146,118,33,12,3,377,218,96,38,17,4,1,3,1206,596,233,377,2686,Census Tract 117.21,08,059,011721,Jefferson County
81,1576,614,214,226,87,57,18,10,2,962,495,272,105,63,19,7,1,1576,480,134,962,3110,Census Tract 117.23,08,059,011723,Jefferson County
82,1506,1438,178,507,265,339,118,26,5,68,10,17,18,10,7,4,2,1506,1210,228,68,4340,Census Tract 117.24,08,059,011724,Jefferson County
83,685,618,123,254,107,101,25,6,2,67,6,11,15,20,11,3,1,685,476,142,67,1776,Census Tract 117.25,08,059,011725,Jefferson County
84,2150,2009,295,846,349,365,105,37,12,141,33,33,29,19,15,7,5,2150,1584,425,141,5754,Census Tract 117.26,08,059,011726,Jefferson County
85,1499,1340,301,577,215,174,48,17,8,159,38,47,33,20,12,3,6,1499,914,426,159,3641,Census Tract 117.27,08,059,011727,Jefferson County
86,1091,933,219,442,112,102,43,8,7,158,46,45,26,24,14,2,1,1091,643,290,158,2566,Census Tract 117.28,08,059,011728,Jefferson County
87,1997,813,405,244,90,57,11,4,2,1184,515,386,167,74,35,6,1,1997,697,116,1184,3871,Census Tract 117.29,08,059,011729,Jefferson County
88,1610,928,339,305,132,99,40,9,4,682,229,188,138,82,32,9,4,1610,789,139,682,3618,Census Tract 117.30,08,059,011730,Jefferson County
89,2009,795,219,308,117,99,35,9,8,1214,522,410,167,77,25,12,1,2009,677,118,1214,4227,Census Tract 117.31,08,059,011731,Jefferson County
90,2452,681,428,192,40,16,4,0,1,1771,813,588,230,91,35,9,5,2452,601,80,1771,4331,Census Tract 117.32,08,059,011732,Jefferson County
91,697,365,134,149,51,18,8,4,1,332,123,86,47,38,26,7,5,697,293,72,332,1530,Census Tract 117.33,08,059,011733,Jefferson County
92,1899,1304,346,431,199,147,98,33,50,595,149,130,106,93,59,33,25,1899,1025,279,595,5276,Census Tract 118.03,08,059,011803,Jefferson County
93,1566,1267,305,519,183,145,67,25,23,299,109,66,43,40,21,6,14,1566,864,403,299,3915,Census Tract 118.04,08,059,011804,Jefferson County
94,2438,338,184,115,20,17,2,0,0,2100,887,763,252,120,53,18,7,2438,304,34,2100,4628,Census Tract 118.05,08,059,011805,Jefferson County
95,2094,1237,410,420,185,118,53,28,23,857,421,137,132,81,48,20,18,2094,867,370,857,4829,Census Tract 118.06,08,059,011806,Jefferson County
96,971,660,263,242,77,48,20,6,4,311,118,85,63,33,8,2,2,971,546,114,311,2030,Census Tract 119.04,08,059,011904,Jefferson County
97,1357,1083,340,449,139,104,29,14,8,274,72,75,49,38,32,5,3,1357,749,334,274,3103,Census Tract 119.51,08,059,011951,Jefferson County
98,2183,1887,426,636,337,337,111,34,6,296,103,88,58,36,8,2,1,2183,1639,248,296,5518,Census Tract 120.22,08,059,012022,Jefferson County
99,1259,1147,235,412,194,193,71,27,15,112,17,30,24,25,7,6,3,1259,978,169,112,3386,Census Tract 120.23,08,059,012023,Jefferson County
100,1860,1673,254,666,305,285,108,40,15,187,69,47,24,27,14,3,3,1860,1381,292,187,4988,Census Tract 120.24,08,059,012024,Jefferson County
101,1470,1123,270,490,166,142,43,9,3,347,133,105,54,38,13,4,0,1470,878,245,347,3368,Census Tract 120.26,08,059,012026,Jefferson County
102,1219,1016,195,475,157,144,31,10,4,203,98,59,32,12,2,0,0,1219,749,267,203,2952,Census Tract 120.27,08,059,012027,Jefferson County
103,1526,1242,218,555,194,195,59,12,9,284,113,93,34,27,14,3,0,1526,997,245,284,3719,Census Tract 120.30,08,059,012030,Jefferson County
104,1481,1327,206,622,211,208,60,14,6,154,43,48,23,24,12,1,3,1481,1116,211,154,3739,Census Tract 120.31,08,059,012031,Jefferson County
105,997,901,126,415,148,147,49,15,1,96,31,26,18,9,9,1,2,997,725,176,96,2574,Census Tract 120.32,08,059,012032,Jefferson County
106,1168,1047,189,485,165,146,45,6,11,121,53,25,17,15,6,3,2,1168,851,196,121,2860,Census Tract 120.33,08,059,012033,Jefferson County
107,1301,1266,129,620,199,219,73,20,6,35,8,15,5,2,2,3,0,1301,932,334,35,3459,Census Tract 120.34,08,059,012034,Jefferson County
108,1791,1747,154,630,366,405,153,30,9,44,7,6,7,14,6,3,1,1791,1427,320,44,5294,Census Tract 120.35,08,059,012035,Jefferson County
109,1324,1267,154,488,215,283,91,26,10,57,21,23,8,4,0,1,0,1324,1096,171,57,3707,Census Tract 120.36,08,059,012036,Jefferson County
110,1385,1245,220,613,181,174,46,7,4,140,41,42,28,16,9,3,1,1385,1083,162,140,3331,Census Tract 120.37,08,059,012037,Jefferson County
111,1167,1050,179,387,204,184,69,22,5,117,27,33,19,20,5,10,3,1167,927,123,117,3160,Census Tract 120.38,08,059,012038,Jefferson County
112,1926,1592,255,561,300,284,123,53,16,334,102,91,57,48,24,8,4,1926,1437,155,334,5312,Census Tract 120.39,08,059,012039,Jefferson County
113,2018,1841,384,737,290,275,91,46,18,177,31,41,38,38,18,8,3,2018,1495,346,177,5253,Census Tract 120.41,08,059,012041,Jefferson County
114,1355,1276,186,450,267,247,78,37,11,79,12,12,14,23,14,1,3,1355,1107,169,79,3851,Census Tract 120.42,08,059,012042,Jefferson County
115,1879,1666,289,594,293,340,110,29,11,213,45,49,55,36,15,12,1,1879,1491,175,213,5124,Census Tract 120.43,08,059,012043,Jefferson County
116,1454,890,113,294,185,207,67,20,4,564,235,172,86,43,20,5,3,1454,795,95,564,3730,Census Tract 120.44,08,059,012044,Jefferson County
117,2178,1843,261,679,366,369,108,41,19,335,108,96,61,50,13,4,3,2178,1647,196,335,5909,Census Tract 120.45,08,059,012045,Jefferson County
118,824,726,148,254,150,102,48,19,5,98,16,29,19,17,8,4,5,824,619,107,98,2207,Census Tract 120.46,08,059,012046,Jefferson County
119,1619,1222,318,447,207,162,63,15,10,397,71,126,95,60,29,14,2,1619,1039,183,397,4053,Census Tract 120.47,08,059,012047,Jefferson County
120,1068,809,153,357,126,109,45,15,4,259,191,38,13,7,6,3,1,1068,596,213,259,2418,Census Tract 120.48,08,059,012048,Jefferson County
121,1344,1279,157,524,238,232,83,32,13,65,14,15,8,15,10,2,1,1344,955,324,65,3752,Census Tract 120.49,08,059,012049,Jefferson County
122,1703,885,128,326,157,166,76,22,10,818,409,275,84,35,10,3,2,1703,718,167,818,3942,Census Tract 120.50,08,059,012050,Jefferson County
123,1266,1182,183,513,194,186,70,22,14,84,14,17,19,12,14,0,8,1266,843,339,84,3425,Census Tract 120.51,08,059,012051,Jefferson County
124,2022,1776,353,650,371,261,93,34,14,246,42,67,56,38,26,12,5,2022,1519,257,246,5326,Census Tract 120.52,08,059,012052,Jefferson County
125,1402,1281,227,498,239,192,83,25,17,121,21,32,19,22,17,5,5,1402,1021,260,121,3794,Census Tract 120.53,08,059,012053,Jefferson County
126,1626,1259,206,464,224,228,103,28,6,367,175,108,46,24,8,4,2,1626,984,275,367,4150,Census Tract 120.54,08,059,012054,Jefferson County
127,1512,1270,299,503,195,182,58,26,7,242,67,79,53,27,10,3,3,1512,1019,251,242,3706,Census Tract 120.55,08,059,012055,Jefferson County
128,2499,2103,674,716,317,271,93,22,10,396,129,141,67,39,10,8,2,2499,1878,225,396,5705,Census Tract 120.57,08,059,012057,Jefferson County
129,1545,1337,238,672,209,143,59,11,5,208,70,69,28,24,14,0,3,1545,1081,256,208,3660,Census Tract 120.58,08,059,012058,Jefferson County
130,1099,858,76,330,167,181,64,26,14,241,42,76,53,36,20,7,7,1099,716,142,241,3245,Census Tract 120.59,08,059,012059,Jefferson County
131,1334,1108,303,379,186,145,61,27,7,226,50,69,44,39,12,5,7,1334,1024,84,226,3336,Census Tract 120.60,08,059,012060,Jefferson County
132,1729,834,251,357,104,85,20,11,6,895,478,229,103,56,20,6,3,1729,600,234,895,3523,Census Tract 158,08,059,015800,Jefferson County
133,1397,457,76,177,94,67,29,10,4,940,361,297,140,91,34,12,5,1397,346,111,940,3411,Census Tract 159,08,059,015900,Jefferson County
134,1584,1424,194,431,342,285,116,36,20,160,12,43,44,33,21,3,4,1584,1292,132,160,4687,Census Tract 603,08,059,060300,Jefferson County
135,1184,1043,139,399,193,193,74,23,22,141,12,31,20,34,22,11,11,1184,892,151,141,3482,Census Tract 604,08,059,060400,Jefferson County
136,1612,1021,147,382,210,182,72,18,10,591,269,191,79,34,13,4,1,1612,878,143,591,4040,Census Tract 605,08,059,060500,Jefferson County
137,0,0,0,0,0,0,0,0,0,0,0,0,0,0,0,0,0,0,0,0,0,0,Census Tract 9800,08,059,980000,Jefferson County
138,0,0,0,0,0,0,0,0,0,0,0,0,0,0,0,0,0,0,0,0,0,1128,Census Tract 9804,08,059,980400,Jefferson County
1,619,429,117,195,51,40,19,4,3,190,83,54,21,13,7,5,7,619,192,237,190,1398,Census Tract 9601,08,061,960100,Kiowa County
1,1882,1308,323,538,171,157,73,32,14,574,250,129,70,58,46,11,10,1882,682,626,574,5597,Census Tract 9621,08,063,962100,Kit Carson County
2,602,453,122,181,49,61,26,12,2,149,59,28,17,19,16,6,4,602,241,212,149,1485,Census Tract 9622,08,063,962200,Kit Carson County
3,554,399,133,168,38,37,15,6,2,155,74,35,20,10,12,4,0,554,186,213,155,1188,Census Tract 9623,08,063,962300,Kit Carson County
1,2212,1412,392,580,206,142,59,24,9,800,325,222,109,87,31,19,7,2212,967,445,800,5140,Census Tract 9617,08,065,961700,Lake County
2,741,565,108,206,73,88,45,29,16,176,48,30,29,29,16,14,10,741,324,241,176,2170,Census Tract 9619,08,065,961900,Lake County
1,2136,1519,328,582,252,183,107,38,29,617,207,155,89,80,53,24,9,2136,914,605,617,5575,Census Tract 9403,08,067,940300,La Plata County
2,2145,1778,337,829,248,222,88,31,23,367,128,101,47,47,28,10,6,2145,1168,610,367,5375,Census Tract 9404,08,067,940400,La Plata County
3,3595,2905,595,1289,416,370,145,57,33,690,227,208,112,81,32,23,7,3595,2208,697,690,8877,Census Tract 9706,08,067,970600,La Plata County
4,1876,1518,266,727,255,191,56,20,3,358,109,109,66,42,19,8,5,1876,1081,437,358,4547,Census Tract 9707.01,08,067,970701,La Plata County
5,2128,1442,294,655,207,186,77,18,5,686,224,200,110,90,45,13,4,2128,1002,440,686,5144,Census Tract 9707.03,08,067,970703,La Plata County
6,1696,1270,330,599,155,139,25,18,4,426,164,141,59,42,14,5,1,1696,807,463,426,3758,Census Tract 9707.04,08,067,970704,La Plata County
7,2464,1315,356,547,205,149,41,14,3,1149,409,379,214,96,39,8,4,2464,922,393,1149,6718,Census Tract 9708,08,067,970800,La Plata County
8,1659,947,256,389,144,116,28,12,2,712,253,213,121,93,23,7,2,1659,636,311,712,3851,Census Tract 9709,08,067,970900,La Plata County
9,1355,769,209,310,125,98,19,5,3,586,198,191,104,52,30,7,4,1355,503,266,586,3154,Census Tract 9710,08,067,971000,La Plata County
10,2046,649,223,241,89,70,19,6,1,1397,576,484,198,89,27,15,8,2046,447,202,1397,4335,Census Tract 9711,08,067,971100,La Plata County
1,1434,319,158,105,27,25,4,0,0,1115,648,302,108,41,12,1,3,1434,213,106,1115,2487,Census Tract 1,08,069,000100,Larimer County
2,1095,385,112,147,53,56,12,3,2,710,242,232,151,65,16,4,0,1095,291,94,710,2461,Census Tract 2.01,08,069,000201,Larimer County
3,1195,604,186,225,85,75,27,5,1,591,210,224,100,34,16,2,5,1195,455,149,591,2594,Census Tract 2.02,08,069,000202,Larimer County
4,1194,885,197,372,156,109,34,15,2,309,85,118,51,34,15,3,3,1194,695,190,309,2851,Census Tract 3,08,069,000300,Larimer County
5,836,408,114,167,72,35,14,3,3,428,149,147,81,27,14,5,5,836,308,100,428,1850,Census Tract 4.01,08,069,000401,Larimer County
6,1176,497,138,189,81,60,21,5,3,679,266,226,103,47,23,10,4,1176,357,140,679,2578,Census Tract 4.02,08,069,000402,Larimer County
7,2103,282,94,115,43,21,6,3,0,1821,470,761,334,193,43,13,7,2103,204,78,1821,5082,Census Tract 5.03,08,069,000503,Larimer County
8,1230,346,108,141,55,31,8,0,3,884,236,318,196,86,32,13,3,1230,222,124,884,2820,Census Tract 5.04,08,069,000504,Larimer County
9,1355,542,209,188,88,44,11,0,2,813,136,285,196,158,29,5,4,1355,357,185,813,3229,Census Tract 5.05,08,069,000505,Larimer County
10,1152,554,149,223,90,70,14,4,4,598,127,171,176,92,22,5,5,1152,445,109,598,2818,Census Tract 5.06,08,069,000506,Larimer County
11,716,11,5,1,4,0,0,1,0,705,391,229,57,17,8,3,0,716,7,4,705,6073,Census Tract 6,08,069,000600,Larimer County
12,1279,499,139,189,86,61,18,4,2,780,321,285,110,39,16,6,3,1279,401,98,780,2733,Census Tract 7,08,069,000700,Larimer County
13,708,414,112,200,54,31,14,2,1,294,114,100,48,18,7,3,4,708,262,152,294,1560,Census Tract 8.01,08,069,000801,Larimer County
14,517,218,59,99,24,19,12,4,1,299,116,88,50,34,6,3,2,517,139,79,299,1214,Census Tract 8.02,08,069,000802,Larimer County
15,2293,1146,342,505,165,100,20,11,3,1147,484,359,178,69,41,8,8,2293,772,374,1147,4868,Census Tract 9.01,08,069,000901,Larimer County
16,1574,777,225,316,107,95,24,6,4,797,283,327,113,44,23,6,1,1574,568,209,797,3358,Census Tract 9.02,08,069,000902,Larimer County
17,2554,977,315,379,144,92,27,12,8,1577,800,430,200,92,31,15,9,2554,759,218,1577,5080,Census Tract 10.03,08,069,001003,Larimer County
18,1377,1123,276,462,162,140,53,23,7,254,74,76,52,25,13,8,6,1377,836,287,254,3351,Census Tract 10.04,08,069,001004,Larimer County
19,1564,580,141,271,92,57,15,2,2,984,492,334,104,35,14,4,1,1564,430,150,984,3002,Census Tract 10.07,08,069,001007,Larimer County
20,860,519,107,199,85,86,28,11,3,341,185,103,26,18,6,3,0,860,404,115,341,1921,Census Tract 10.08,08,069,001008,Larimer County
21,2553,1758,376,654,255,312,114,31,16,795,392,235,84,53,18,8,5,2553,1436,322,795,6149,Census Tract 10.09,08,069,001009,Larimer County
22,1137,901,163,416,122,141,40,15,4,236,144,61,16,10,3,1,1,1137,609,292,236,2753,Census Tract 10.10,08,069,001010,Larimer County
23,2343,1355,358,505,238,168,53,23,10,988,222,351,242,116,34,13,10,2343,1121,234,988,5671,Census Tract 11.04,08,069,001104,Larimer County
24,2184,1117,209,464,209,154,56,17,8,1067,324,378,203,105,39,11,7,2184,890,227,1067,5246,Census Tract 11.06,08,069,001106,Larimer County
25,2205,1288,347,477,212,175,50,19,8,917,219,316,211,109,37,16,9,2205,1062,226,917,5329,Census Tract 11.07,08,069,001107,Larimer County
26,1956,1211,279,426,235,189,59,17,6,745,151,254,163,120,45,9,3,1956,988,223,745,4961,Census Tract 11.09,08,069,001109,Larimer County
27,2268,815,153,366,144,106,32,7,7,1453,552,542,226,102,21,7,3,2268,578,237,1453,4884,Census Tract 11.10,08,069,001110,Larimer County
28,1015,283,98,114,38,25,8,0,0,732,320,263,87,42,16,3,1,1015,197,86,732,2056,Census Tract 11.11,08,069,001111,Larimer County
29,1657,1331,214,480,266,238,91,31,11,326,50,70,85,68,41,9,3,1657,952,379,326,4646,Census Tract 11.12,08,069,001112,Larimer County
30,1277,1070,147,350,192,257,80,27,17,207,95,38,28,28,11,5,2,1277,892,178,207,3636,Census Tract 11.13,08,069,001113,Larimer County
31,863,812,90,378,153,123,44,19,5,51,11,17,9,6,5,0,3,863,595,217,51,2311,Census Tract 11.14,08,069,001114,Larimer County
32,1538,1096,211,490,182,130,58,20,5,442,150,160,55,51,15,8,3,1538,814,282,442,3697,Census Tract 13.01,08,069,001301,Larimer County
33,1034,708,174,192,85,103,74,43,37,326,151,87,33,21,16,15,3,1034,238,470,326,2834,Census Tract 13.04,08,069,001304,Larimer County
34,800,463,99,173,86,65,25,12,3,337,69,105,80,51,20,8,4,800,404,59,337,2189,Census Tract 13.05,08,069,001305,Larimer County
35,660,410,87,112,75,65,38,13,20,250,52,55,66,44,23,6,4,660,265,145,250,2003,Census Tract 13.06,08,069,001306,Larimer County
36,1647,1276,268,562,198,162,56,21,9,371,69,114,72,65,34,12,5,1647,965,311,371,4161,Census Tract 13.07,08,069,001307,Larimer County
37,1805,1554,278,720,245,203,76,23,9,251,76,68,40,39,19,6,3,1805,1187,367,251,4501,Census Tract 13.08,08,069,001308,Larimer County
38,726,467,139,184,69,46,15,11,3,259,69,96,49,30,4,7,4,726,344,123,259,1681,Census Tract 16.01,08,069,001601,Larimer County
39,1828,1127,194,373,222,222,83,26,7,701,253,269,98,51,22,6,2,1828,969,158,701,4573,Census Tract 16.02,08,069,001602,Larimer County
40,1861,1373,248,438,251,252,105,50,29,488,144,138,80,57,34,17,18,1861,1070,303,488,5222,Census Tract 16.03,08,069,001603,Larimer County
41,906,745,199,238,111,122,41,27,7,161,41,45,43,22,8,1,1,906,665,80,161,3189,Census Tract 16.05,08,069,001605,Larimer County
42,1145,726,112,221,138,171,67,12,5,419,181,140,45,31,15,6,1,1145,649,77,419,2935,Census Tract 16.06,08,069,001606,Larimer County
43,1419,1094,239,368,182,204,64,29,8,325,72,109,69,45,21,8,1,1419,956,138,325,3726,Census Tract 16.07,08,069,001607,Larimer County
44,1623,1394,151,338,267,397,162,66,13,229,57,69,48,33,13,5,4,1623,1241,153,229,5116,Census Tract 16.08,08,069,001608,Larimer County
45,3264,1838,531,686,278,194,95,34,20,1426,490,385,230,158,99,37,27,3264,1423,415,1426,7876,Census Tract 17.04,08,069,001704,Larimer County
46,2623,1615,310,661,270,237,86,33,18,1008,367,242,158,128,73,24,16,2623,1199,416,1008,6647,Census Tract 17.06,08,069,001706,Larimer County
47,1972,1490,295,509,280,264,96,30,16,482,132,159,88,59,25,14,5,1972,1146,344,482,5200,Census Tract 17.07,08,069,001707,Larimer County
48,1207,921,157,346,164,169,54,23,8,286,50,109,65,36,16,6,4,1207,801,120,286,3236,Census Tract 17.08,08,069,001708,Larimer County
49,4523,3575,557,1586,541,567,229,69,26,948,326,313,126,99,50,25,9,4523,2893,682,948,11580,Census Tract 17.09,08,069,001709,Larimer County
50,1536,954,234,409,145,102,32,20,12,582,176,174,102,68,41,12,9,1536,691,263,582,3711,Census Tract 18.04,08,069,001804,Larimer County
51,2850,2169,395,1005,297,289,136,33,14,681,272,168,97,69,59,10,6,2850,1663,506,681,7133,Census Tract 18.06,08,069,001806,Larimer County
52,2160,1726,331,713,320,256,75,17,14,434,88,112,101,70,36,20,7,2160,1304,422,434,5566,Census Tract 18.07,08,069,001807,Larimer County
53,1814,1519,246,719,225,207,76,28,18,295,118,74,44,34,15,8,2,1814,1109,410,295,4707,Census Tract 18.08,08,069,001808,Larimer County
54,3831,3446,541,1350,565,636,243,77,34,385,91,99,69,73,33,15,5,3831,2825,621,385,10495,Census Tract 18.09,08,069,001809,Larimer County
55,1672,928,270,394,118,87,40,9,10,744,278,230,114,75,26,13,8,1672,637,291,744,3846,Census Tract 19.01,08,069,001901,Larimer County
56,1984,1235,327,561,155,119,48,16,9,749,297,192,122,87,31,16,4,1984,805,430,749,4466,Census Tract 19.02,08,069,001902,Larimer County
57,1670,1475,327,781,173,128,37,22,7,195,93,62,18,12,5,2,3,1670,1040,435,195,3765,Census Tract 19.03,08,069,001903,Larimer County
58,1980,1201,280,441,203,178,63,24,12,779,184,232,167,107,53,20,16,1980,1002,199,779,5130,Census Tract 20.05,08,069,002005,Larimer County
59,1616,677,218,274,87,62,26,6,4,939,552,248,75,37,16,9,2,1616,535,142,939,3144,Census Tract 20.07,08,069,002007,Larimer County
60,1401,886,170,385,146,121,41,17,6,515,232,120,62,56,31,7,7,1401,688,198,515,3498,Census Tract 20.08,08,069,002008,Larimer County
61,924,880,98,427,155,122,48,22,8,44,10,12,7,8,4,2,1,924,671,209,44,2518,Census Tract 20.10,08,069,002010,Larimer County
62,1952,1671,260,722,289,239,100,42,19,281,48,86,56,56,21,8,6,1952,1321,350,281,5231,Census Tract 20.11,08,069,002011,Larimer County
63,1417,1028,215,439,173,140,46,10,5,389,121,166,54,29,11,4,4,1417,796,232,389,3340,Census Tract 23,08,069,002300,Larimer County
64,574,505,100,321,42,27,8,7,0,69,26,27,12,2,1,0,1,574,309,196,69,1217,Census Tract 24.01,08,069,002401,Larimer County
65,1349,1177,251,648,131,108,23,11,5,172,72,63,22,9,4,2,0,1349,812,365,172,2963,Census Tract 24.02,08,069,002402,Larimer County
66,2788,2537,370,1117,372,399,186,69,24,251,63,65,41,39,27,6,10,2788,1859,678,251,7573,Census Tract 25.01,08,069,002501,Larimer County
67,2885,2348,372,892,402,391,199,63,29,537,119,152,88,100,46,20,12,2885,2044,304,537,8118,Census Tract 25.02,08,069,002502,Larimer County
68,1002,871,131,395,141,126,45,26,7,131,41,41,13,18,11,3,4,1002,678,193,131,2620,Census Tract 25.03,08,069,002503,Larimer County
69,2298,2117,254,1009,342,301,121,51,39,181,52,55,33,26,9,3,3,2298,1678,439,181,6317,Census Tract 26,08,069,002600,Larimer County
70,2051,1541,365,559,261,219,81,39,17,510,188,129,75,72,30,10,6,2051,1194,347,510,5192,Census Tract 27,08,069,002700,Larimer County
71,1546,1015,317,538,80,56,18,4,2,531,248,148,58,39,23,8,7,1546,619,396,531,3189,Census Tract 28.01,08,069,002801,Larimer County
72,2697,1930,471,1073,185,139,42,12,8,767,325,211,90,77,38,17,9,2697,1247,683,767,5861,Census Tract 28.02,08,069,002802,Larimer County
73,47,6,2,4,0,0,0,0,0,41,21,10,4,3,1,2,0,47,4,2,41,92,Census Tract 28.03,08,069,002803,Larimer County
1,1688,1126,333,428,168,107,51,26,13,562,238,122,86,68,28,9,11,1688,640,486,562,3930,Census Tract 1,08,071,000100,Las Animas County
2,941,631,210,226,84,64,28,13,6,310,108,79,54,36,16,10,7,941,381,250,310,2371,Census Tract 2,08,071,000200,Las Animas County
3,992,834,214,417,103,58,27,11,4,158,54,46,36,6,13,1,2,992,462,372,158,2184,Census Tract 3,08,071,000300,Las Animas County
4,991,619,163,244,93,72,32,12,3,372,185,93,35,35,18,5,1,991,386,233,372,2284,Census Tract 4,08,071,000400,Las Animas County
5,844,521,173,201,59,48,25,11,4,323,149,79,42,22,22,9,0,844,300,221,323,1972,Census Tract 5,08,071,000500,Las Animas County
6,928,742,175,300,116,94,37,14,6,186,67,40,26,23,23,5,2,928,412,330,186,2766,Census Tract 8,08,071,000800,Las Animas County
1,1054,656,173,251,114,73,30,9,6,398,190,85,52,32,25,9,5,1054,418,238,398,3363,Census Tract 9617,08,073,961700,Lincoln County
2,894,641,188,277,67,63,35,3,8,253,103,64,38,31,8,6,3,894,305,336,253,2104,Census Tract 9618,08,073,961800,Lincoln County
1,464,348,88,151,38,41,22,5,3,116,44,35,15,12,7,2,1,464,202,146,116,1090,Census Tract 9659,08,075,965900,Logan County
2,893,687,137,301,94,99,39,13,4,206,66,50,31,33,20,4,2,893,409,278,206,2248,Census Tract 9660,08,075,966000,Logan County
3,2945,2066,480,845,301,262,115,45,18,879,314,237,148,97,48,24,11,2945,1323,743,879,7348,Census Tract 9661,08,075,966100,Logan County
4,1306,602,185,229,76,69,31,8,4,704,404,151,57,49,29,9,5,1306,383,219,704,3111,Census Tract 9662,08,075,966200,Logan County
5,1813,1248,383,520,148,118,58,13,8,565,278,133,58,40,25,7,24,1813,719,529,565,4080,Census Tract 9663,08,075,966300,Logan County
6,626,509,105,227,69,61,32,8,7,117,39,36,18,14,6,3,1,626,300,209,117,4832,Census Tract 9664,08,075,966400,Logan County
1,1126,337,112,129,45,29,14,6,2,789,462,197,68,41,10,4,7,1126,248,89,789,2110,Census Tract 2,08,077,000200,Mesa County
2,731,251,90,99,34,18,5,2,3,480,271,129,46,19,9,5,1,731,201,50,480,1362,Census Tract 3,08,077,000300,Mesa County
3,1568,989,321,366,142,100,39,13,8,579,238,175,78,49,19,12,8,1568,531,458,579,3513,Census Tract 4,08,077,000400,Mesa County
4,759,206,68,70,34,20,9,2,3,553,324,110,62,30,18,6,3,759,154,52,553,2891,Census Tract 5,08,077,000500,Mesa County
5,1956,992,357,364,130,86,36,10,9,964,440,275,136,67,24,11,11,1956,717,275,964,4246,Census Tract 6.01,08,077,000601,Mesa County
6,2140,1046,357,365,149,94,42,26,13,1094,459,303,151,98,48,22,13,2140,727,319,1094,4803,Census Tract 6.02,08,077,000602,Mesa County
7,1770,903,263,316,126,105,54,21,18,867,353,225,107,99,48,24,11,1770,662,241,867,4411,Census Tract 7,08,077,000700,Mesa County
8,2764,2123,455,694,376,346,156,57,39,641,110,155,143,103,71,45,14,2764,1749,374,641,8230,Census Tract 8,08,077,000800,Mesa County
9,1098,702,239,269,80,67,29,8,10,396,105,131,72,52,18,12,6,1098,492,210,396,2971,Census Tract 9,08,077,000900,Mesa County
10,2217,1560,371,747,200,161,54,20,7,657,451,99,36,38,20,6,7,2217,1001,559,657,4764,Census Tract 10.01,08,077,001001,Mesa County
11,2884,2040,490,953,252,214,87,29,15,844,425,224,73,78,28,8,8,2884,1407,633,844,6459,Census Tract 10.02,08,077,001002,Mesa County
12,3260,2121,564,821,320,249,97,45,25,1139,305,294,253,166,79,22,20,3260,1543,578,1139,8132,Census Tract 11.01,08,077,001101,Mesa County
13,1831,1591,332,663,271,204,84,23,14,240,45,58,43,38,38,12,6,1831,1144,447,240,4709,Census Tract 11.02,08,077,001102,Mesa County
14,843,714,115,363,100,76,36,14,10,129,40,43,13,23,8,2,0,843,450,264,129,2098,Census Tract 12,08,077,001200,Mesa County
15,3512,2356,572,915,355,287,156,46,25,1156,342,299,256,138,73,40,8,3512,1852,504,1156,8825,Census Tract 13.01,08,077,001301,Mesa County
16,1842,1567,277,680,253,218,78,34,27,275,60,71,53,36,32,14,9,1842,1152,415,275,4909,Census Tract 13.02,08,077,001302,Mesa County
17,2326,2099,358,985,293,280,108,51,24,227,67,54,30,39,21,10,6,2326,1428,671,227,5998,Census Tract 14.02,08,077,001402,Mesa County
18,1446,1194,249,543,180,140,50,22,10,252,66,77,48,37,11,6,7,1446,806,388,252,3582,Census Tract 14.03,08,077,001403,Mesa County
19,1999,1777,358,912,226,185,61,28,7,222,51,73,35,46,10,3,4,1999,1168,609,222,4708,Census Tract 14.04,08,077,001404,Mesa County
20,4767,3586,691,1355,579,589,237,90,45,1181,382,263,218,169,101,37,11,4767,2845,741,1181,12810,Census Tract 15.01,08,077,001501,Mesa County
21,2655,2284,341,1001,362,318,153,52,57,371,97,111,63,51,27,11,11,2655,1622,662,371,7214,Census Tract 15.02,08,077,001502,Mesa County
22,1406,1220,184,567,188,179,63,24,15,186,68,58,25,13,9,8,5,1406,832,388,186,3631,Census Tract 16,08,077,001600,Mesa County
23,1940,1361,352,592,194,131,54,26,12,579,274,138,73,46,28,13,7,1940,866,495,579,4455,Census Tract 17.02,08,077,001702,Mesa County
24,1641,1390,311,542,206,196,87,36,12,251,57,67,40,45,23,10,9,1641,1043,347,251,4271,Census Tract 17.03,08,077,001703,Mesa County
25,2043,1362,299,465,230,193,114,38,23,681,164,195,128,113,53,19,9,2043,1081,281,681,5500,Census Tract 17.05,08,077,001705,Mesa County
26,2152,1249,298,428,181,177,98,47,20,903,176,217,193,176,90,34,17,2152,850,399,903,6008,Census Tract 17.06,08,077,001706,Mesa County
27,2092,1676,389,584,288,251,109,31,24,416,66,106,98,76,46,17,7,2092,1291,385,416,5600,Census Tract 17.07,08,077,001707,Mesa County
28,1304,1030,214,497,113,123,57,18,8,274,79,89,36,38,21,5,6,1304,653,377,274,3424,Census Tract 18,08,077,001800,Mesa County
29,2023,1780,329,849,248,199,98,33,24,243,75,78,29,25,14,12,10,2023,1273,507,243,5089,Census Tract 19,08,077,001900,Mesa County
1,355,294,86,155,31,19,2,1,0,61,29,13,6,9,3,0,1,355,142,152,61,712,Census Tract 9736,08,079,973600,Mineral County
1,1219,915,143,406,148,132,51,21,14,304,98,90,64,31,12,3,6,1219,658,257,304,3138,Census Tract 3,08,081,000300,Moffat County
2,1725,1150,249,436,175,151,85,29,25,575,219,118,91,75,48,16,8,1725,815,335,575,4523,Census Tract 4,08,081,000400,Moffat County
3,1865,1226,308,476,175,172,59,24,12,639,261,155,76,79,45,18,5,1865,897,329,639,4526,Census Tract 5,08,081,000500,Moffat County
4,656,512,114,228,76,47,26,8,13,144,60,33,14,22,11,2,2,656,281,231,144,1608,Census Tract 6,08,081,000600,Moffat County
1,508,289,65,71,52,39,27,18,17,219,46,55,42,30,23,14,9,508,81,208,219,1588,Census Tract 9411,08,083,941100,Montezuma County
2,1487,1151,290,541,155,92,47,17,9,336,138,88,45,31,21,9,4,1487,644,507,336,3380,Census Tract 9690,08,083,969000,Montezuma County
3,1378,993,256,477,132,74,40,8,6,385,155,100,56,31,26,15,2,1378,639,354,385,3156,Census Tract 9691,08,083,969100,Montezuma County
4,1202,1038,217,497,144,101,47,24,8,164,49,57,17,22,11,5,3,1202,618,420,164,2894,Census Tract 9692,08,083,969200,Montezuma County
5,2418,1790,475,764,259,176,62,34,20,628,224,183,96,67,33,18,7,2418,1111,679,628,5754,Census Tract 9693,08,083,969300,Montezuma County
6,1657,841,234,333,105,82,60,19,8,816,313,208,125,106,40,14,10,1657,520,321,816,3911,Census Tract 9694,08,083,969400,Montezuma County
7,1891,1527,316,662,247,156,77,36,33,364,112,89,49,63,31,10,10,1891,808,719,364,4852,Census Tract 9696,08,083,969600,Montezuma County
1,1214,928,273,409,99,81,46,15,5,286,104,82,34,37,18,7,4,1214,456,472,286,2749,Census Tract 9661,08,085,966100,Montrose County
2,1108,866,155,425,99,96,59,24,8,242,54,72,28,40,31,6,11,1108,521,345,242,2906,Census Tract 9662.01,08,085,966201,Montrose County
3,1513,1048,172,430,147,143,89,29,38,465,118,94,80,90,48,21,14,1513,709,339,465,4426,Census Tract 9662.02,08,085,966202,Montrose County
4,2555,1406,412,506,193,165,77,38,15,1149,460,279,179,111,79,26,15,2555,897,509,1149,6205,Census Tract 9663,08,085,966300,Montrose County
5,2626,1542,459,657,171,143,63,34,15,1084,523,244,118,89,70,25,15,2626,922,620,1084,6110,Census Tract 9664,08,085,966400,Montrose County
6,1136,961,137,527,121,104,45,20,7,175,36,58,27,27,15,7,5,1136,609,352,175,2876,Census Tract 9665.01,08,085,966501,Montrose County
7,1536,1216,240,550,171,155,69,21,10,320,75,77,57,63,30,14,4,1536,885,331,320,3932,Census Tract 9665.02,08,085,966502,Montrose County
8,1311,1062,230,459,143,119,68,29,14,249,72,75,39,36,18,6,3,1311,668,394,249,3309,Census Tract 9665.03,08,085,966503,Montrose County
9,1677,1353,308,539,185,175,74,47,25,324,74,91,64,40,39,10,6,1677,869,484,324,4392,Census Tract 9666.01,08,085,966601,Montrose County
10,1808,1543,276,819,182,146,90,18,12,265,78,81,42,37,15,8,4,1808,970,573,265,4371,Census Tract 9666.02,08,085,966602,Montrose County
1,979,772,120,342,116,122,46,14,12,207,51,64,36,31,14,7,4,979,501,271,207,2600,Census Tract 1,08,087,000100,Morgan County
2,943,694,114,284,119,93,49,20,15,249,69,58,43,36,26,8,9,943,505,189,249,2595,Census Tract 2,08,087,000200,Morgan County
3,639,441,86,181,78,48,22,19,7,198,58,49,27,34,21,4,5,639,268,173,198,1697,Census Tract 3,08,087,000300,Morgan County
4,1766,1014,275,359,140,112,74,25,29,752,332,171,90,71,48,25,15,1766,641,373,752,4420,Census Tract 4,08,087,000400,Morgan County
5,841,478,111,153,65,62,45,24,18,363,119,75,71,52,27,10,9,841,344,134,363,2425,Census Tract 5,08,087,000500,Morgan County
6,2136,1431,257,493,210,196,141,81,53,705,128,137,141,117,92,54,36,2136,908,523,705,6634,Census Tract 6,08,087,000600,Morgan County
7,2286,1303,294,499,179,151,111,40,29,983,476,202,112,97,56,24,16,2286,842,461,983,5979,Census Tract 7,08,087,000700,Morgan County
8,704,558,97,267,80,64,33,12,5,146,43,30,20,28,16,9,0,704,368,190,146,1809,Census Tract 8,08,087,000800,Morgan County
1,703,481,135,210,60,38,29,6,3,222,100,50,24,29,13,6,0,703,286,195,222,1617,Census Tract 9680,08,089,968000,Otero County
2,1123,576,147,222,89,53,42,18,5,547,222,122,78,70,34,13,8,1123,336,240,547,2718,Census Tract 9681,08,089,968100,Otero County
3,1112,849,196,392,104,91,41,17,8,263,106,72,32,28,12,7,6,1112,482,367,263,2708,Census Tract 9682,08,089,968200,Otero County
4,1612,1063,246,427,186,128,46,24,6,549,251,131,66,68,23,6,4,1612,642,421,549,3819,Census Tract 9683,08,089,968300,Otero County
5,450,310,75,124,46,32,21,9,3,140,46,37,22,16,16,2,1,450,151,159,140,1119,Census Tract 9684,08,089,968400,Otero County
6,725,560,117,255,80,60,28,12,8,165,55,43,30,18,13,6,0,725,321,239,165,1832,Census Tract 9685,08,089,968500,Otero County
7,2004,1180,356,409,188,118,64,30,15,824,311,214,119,89,58,20,13,2004,687,493,824,5018,Census Tract 9686,08,089,968600,Otero County
1,2022,1498,328,812,180,123,42,9,4,524,207,156,65,51,33,8,4,2022,961,537,524,4436,Census Tract 9676,08,091,967600,Ouray County
1,2409,2091,499,963,277,237,69,36,10,318,116,89,55,32,15,5,6,2409,1741,350,318,5587,Census Tract 1,08,093,000100,Park County
2,1469,1261,233,590,193,160,62,18,5,208,56,60,35,31,18,7,1,1469,1074,187,208,3647,Census Tract 2,08,093,000200,Park County
3,1216,881,282,377,109,88,20,4,1,335,133,88,44,32,29,5,4,1216,682,199,335,2694,Census Tract 3,08,093,000300,Park County
4,1022,885,256,460,79,66,18,2,4,137,60,37,16,18,1,3,2,1022,610,275,137,2099,Census Tract 4,08,093,000400,Park County
5,1058,951,263,508,102,48,19,7,4,107,42,33,11,13,7,0,1,1058,604,347,107,2179,Census Tract 5,08,093,000500,Park County
1,1218,836,208,330,95,106,64,20,13,382,180,79,37,48,26,5,7,1218,499,337,382,3011,Census Tract 9676,08,095,967600,Phillips County
2,601,470,119,207,55,57,21,8,3,131,58,26,15,17,8,2,5,601,272,198,131,1431,Census Tract 9677,08,095,967700,Phillips County
1,3363,2170,532,876,358,255,101,30,18,1193,498,393,136,108,32,18,8,3363,1569,601,1193,7681,Census Tract 1,08,097,000100,Pitkin County
2,2417,1338,535,521,148,88,33,10,3,1079,577,345,101,34,13,6,3,2417,841,497,1079,4471,Census Tract 4.01,08,097,000401,Pitkin County
3,1305,694,226,249,86,99,26,7,1,611,364,173,36,25,11,2,0,1305,486,208,611,2563,Census Tract 4.02,08,097,000402,Pitkin County
4,1067,702,226,223,112,89,35,10,7,365,139,115,57,41,8,3,2,1067,555,147,365,2433,Census Tract 5,08,097,000500,Pitkin County
1,575,442,67,206,66,65,26,7,5,133,48,37,16,15,14,3,0,575,260,182,133,1462,Census Tract 1,08,099,000100,Prowers County
2,928,558,154,170,96,66,44,18,10,370,135,86,51,37,43,15,3,928,293,265,370,2470,Census Tract 2,08,099,000200,Prowers County
3,2025,1259,309,498,179,128,93,34,18,766,347,199,93,62,35,22,8,2025,815,444,766,4975,Census Tract 3,08,099,000300,Prowers County
4,545,420,97,172,61,49,24,10,7,125,35,37,20,15,13,4,1,545,198,222,125,1424,Census Tract 6,08,099,000600,Prowers County
5,862,600,132,254,81,74,24,28,7,262,71,74,44,34,31,7,1,862,326,274,262,2220,Census Tract 7,08,099,000700,Prowers County
1,1192,816,255,319,108,93,27,11,3,376,125,125,62,38,19,3,4,1192,567,249,376,2692,Census Tract 1,08,101,000100,Pueblo County
2,721,467,141,145,76,58,36,7,4,254,67,56,47,49,19,10,6,721,337,130,254,1857,Census Tract 2,08,101,000200,Pueblo County
3,0,0,0,0,0,0,0,0,0,0,0,0,0,0,0,0,0,0,0,0,0,1332,Census Tract 3,08,101,000300,Pueblo County
4,1156,695,255,241,101,60,18,9,11,461,165,119,80,53,32,9,3,1156,483,212,461,2602,Census Tract 4,08,101,000400,Pueblo County
5,1021,616,222,236,71,53,23,7,4,405,157,118,62,34,24,8,2,1021,395,221,405,2204,Census Tract 5,08,101,000500,Pueblo County
6,938,323,110,100,45,33,22,5,8,615,259,170,79,60,28,12,7,938,234,89,615,2153,Census Tract 6,08,101,000600,Pueblo County
7,1187,515,150,164,84,62,29,14,12,672,262,155,108,72,42,22,11,1187,336,179,672,3031,Census Tract 8,08,101,000800,Pueblo County
8,2315,1254,302,470,192,162,78,33,17,1061,390,271,176,113,71,21,19,2315,851,403,1061,5802,Census Tract 9.02,08,101,000902,Pueblo County
9,34,0,0,0,0,0,0,0,0,34,1,2,11,17,3,0,0,34,0,0,34,777,Census Tract 9.03,08,101,000903,Pueblo County
10,2005,1244,379,469,178,126,53,27,12,761,469,120,58,65,28,16,5,2005,794,450,761,4350,Census Tract 9.04,08,101,000904,Pueblo County
11,1111,237,82,95,27,23,5,2,3,874,397,267,133,42,21,9,5,1111,157,80,874,2202,Census Tract 9.05,08,101,000905,Pueblo County
12,1751,972,252,328,170,98,58,39,27,779,191,197,145,107,80,41,18,1751,632,340,779,4758,Census Tract 10,08,101,001000,Pueblo County
13,1055,612,167,209,97,74,30,23,12,443,118,95,89,60,54,13,14,1055,398,214,443,2834,Census Tract 11,08,101,001100,Pueblo County
14,782,447,139,144,62,49,30,12,11,335,81,66,60,62,44,17,5,782,269,178,335,2126,Census Tract 12,08,101,001200,Pueblo County
15,662,233,81,80,34,18,9,7,4,429,223,107,41,37,13,5,3,662,133,100,429,1375,Census Tract 14,08,101,001400,Pueblo County
16,989,599,228,216,76,50,23,2,4,390,190,107,37,30,18,6,2,989,425,174,390,2025,Census Tract 15,08,101,001500,Pueblo County
17,758,604,202,262,67,49,19,5,0,154,55,55,22,9,9,2,2,758,362,242,154,1710,Census Tract 16,08,101,001600,Pueblo County
18,1900,1517,472,672,187,107,53,15,11,383,136,86,66,53,30,7,5,1900,853,664,383,4196,Census Tract 17,08,101,001700,Pueblo County
19,984,692,275,234,81,66,21,6,9,292,93,83,52,39,13,8,4,984,493,199,292,2176,Census Tract 18,08,101,001800,Pueblo County
20,675,292,95,111,29,33,15,7,2,383,197,92,36,20,25,11,2,675,199,93,383,1445,Census Tract 19,08,101,001900,Pueblo County
21,1220,648,245,216,84,47,30,12,14,572,171,150,110,59,44,28,10,1220,368,280,572,2940,Census Tract 20,08,101,002000,Pueblo County
22,628,296,98,95,47,24,18,11,3,332,130,68,62,30,19,13,10,628,186,110,332,1526,Census Tract 21,08,101,002100,Pueblo County
23,640,392,141,110,64,42,18,12,5,248,75,53,43,33,22,14,8,640,251,141,248,1650,Census Tract 22,08,101,002200,Pueblo County
24,1487,783,256,280,113,73,37,18,6,704,278,208,105,61,40,8,4,1487,523,260,704,3476,Census Tract 23,08,101,002300,Pueblo County
25,792,533,184,177,64,59,33,7,9,259,76,63,52,36,21,6,5,792,358,175,259,1928,Census Tract 24,08,101,002400,Pueblo County
26,1155,713,247,236,103,63,37,17,10,442,131,124,81,53,28,15,10,1155,489,224,442,2782,Census Tract 25,08,101,002500,Pueblo County
27,1638,589,211,208,84,46,22,12,6,1049,417,253,184,112,55,19,9,1638,371,218,1049,3880,Census Tract 26,08,101,002600,Pueblo County
28,2236,1621,491,635,221,153,74,33,14,615,150,149,130,106,50,23,7,2236,1008,613,615,5434,Census Tract 27,08,101,002700,Pueblo County
29,2052,1433,368,490,256,169,86,37,27,619,273,133,70,70,49,9,15,2052,952,481,619,5268,Census Tract 28.01,08,101,002801,Pueblo County
30,1534,1148,343,450,164,109,49,19,14,386,132,106,60,46,22,15,5,1534,811,337,386,3586,Census Tract 28.02,08,101,002802,Pueblo County
31,1857,1546,306,745,189,167,79,41,19,311,96,101,45,36,18,9,6,1857,1035,511,311,4661,Census Tract 28.04,08,101,002804,Pueblo County
32,1382,1247,254,549,164,168,65,31,16,135,40,27,26,23,9,9,1,1382,922,325,135,3519,Census Tract 28.06,08,101,002806,Pueblo County
33,1686,1377,302,499,228,223,87,26,12,309,68,87,53,54,30,13,4,1686,1011,366,309,4430,Census Tract 28.07,08,101,002807,Pueblo County
34,1110,1075,160,448,188,173,66,29,11,35,7,13,6,5,4,0,0,1110,785,290,35,2989,Census Tract 28.08,08,101,002808,Pueblo County
35,1133,473,99,166,86,61,33,20,8,660,252,134,120,79,50,10,15,1133,354,119,660,2914,Census Tract 29.01,08,101,002901,Pueblo County
36,2448,1733,481,631,283,222,76,25,15,715,206,222,121,89,59,13,5,2448,1280,453,715,5901,Census Tract 29.03,08,101,002903,Pueblo County
37,1435,1373,218,608,190,202,103,31,21,62,5,14,9,14,12,6,2,1435,1109,264,62,3905,Census Tract 29.06,08,101,002906,Pueblo County
38,904,845,99,349,141,147,76,20,13,59,8,12,10,15,8,1,5,904,710,135,59,2611,Census Tract 29.11,08,101,002911,Pueblo County
39,621,266,41,97,45,41,25,14,3,355,99,95,81,44,24,10,2,621,233,33,355,1689,Census Tract 29.12,08,101,002912,Pueblo County
40,1264,1190,182,549,166,179,83,21,10,74,19,21,8,17,3,4,2,1264,898,292,74,3318,Census Tract 29.13,08,101,002913,Pueblo County
41,1147,814,133,271,172,130,71,22,15,333,96,101,52,47,24,11,2,1147,706,108,333,3210,Census Tract 29.14,08,101,002914,Pueblo County
42,920,523,104,203,81,70,27,22,16,397,94,106,79,73,32,7,6,920,427,96,397,2525,Census Tract 29.15,08,101,002915,Pueblo County
43,1189,854,253,323,102,95,47,23,11,335,78,90,61,55,31,15,5,1189,611,243,335,3004,Census Tract 29.16,08,101,002916,Pueblo County
44,1047,854,125,349,144,147,63,14,12,193,31,43,46,41,22,7,3,1047,691,163,193,2935,Census Tract 29.17,08,101,002917,Pueblo County
45,2275,2099,257,832,346,371,178,73,42,176,34,41,32,29,26,10,4,2275,1867,232,176,6646,Census Tract 29.18,08,101,002918,Pueblo County
46,492,355,97,133,45,48,14,14,4,137,33,38,29,21,10,4,2,492,187,168,137,1244,Census Tract 30.01,08,101,003001,Pueblo County
47,913,777,121,326,155,101,49,19,6,136,51,26,21,17,11,4,6,913,575,202,136,2721,Census Tract 30.04,08,101,003004,Pueblo County
48,751,545,132,208,86,72,27,11,9,206,59,56,38,35,11,6,1,751,283,262,206,1885,Census Tract 31.03,08,101,003103,Pueblo County
49,876,779,147,349,118,107,39,13,6,97,31,23,15,14,4,9,1,876,498,281,97,2210,Census Tract 31.04,08,101,003104,Pueblo County
50,1172,1056,157,447,165,165,78,30,14,116,29,38,17,14,10,6,2,1172,706,350,116,3204,Census Tract 31.05,08,101,003105,Pueblo County
51,453,411,79,162,72,57,22,8,11,42,10,9,14,4,2,2,1,453,276,135,42,1283,Census Tract 31.06,08,101,003106,Pueblo County
52,1343,1036,200,419,160,140,73,25,19,307,98,74,48,35,25,16,11,1343,650,386,307,3572,Census Tract 32,08,101,003200,Pueblo County
53,1088,209,86,70,24,16,10,0,3,879,652,138,47,23,8,6,5,1088,123,86,879,2374,Census Tract 35,08,101,003500,Pueblo County
54,848,520,145,178,73,62,34,20,8,328,139,49,47,45,28,14,6,848,305,215,328,2196,Census Tract 36,08,101,003600,Pueblo County
55,0,0,0,0,0,0,0,0,0,0,0,0,0,0,0,0,0,0,0,0,0,0,Census Tract 9801,08,101,980100,Pueblo County
1,1592,1100,248,485,147,132,57,23,8,492,183,136,65,63,31,11,3,1592,681,419,492,3858,Census Tract 9511,08,103,951100,Rio Blanco County
2,1055,775,160,325,101,122,45,15,7,280,116,60,46,32,15,8,3,1055,546,229,280,2808,Census Tract 9512,08,103,951200,Rio Blanco County
1,2106,1337,317,516,202,154,86,38,24,769,295,189,126,96,38,13,12,2106,874,463,769,5323,Census Tract 9767,08,105,976700,Rio Grande County
2,758,482,104,205,66,54,30,17,6,276,114,67,37,37,12,8,1,758,270,212,276,1930,Census Tract 9768,08,105,976800,Rio Grande County
3,1915,1399,265,712,170,133,66,28,25,516,174,125,83,84,33,12,5,1915,837,562,516,4729,Census Tract 9770,08,105,977000,Rio Grande County
1,913,737,148,351,111,87,28,7,5,176,56,65,24,19,8,2,2,913,517,220,176,2151,Census Tract 1,08,107,000100,Routt County
2,784,535,131,197,90,77,29,5,6,249,98,55,46,22,17,9,2,784,394,141,249,1925,Census Tract 2,08,107,000200,Routt County
3,990,755,167,330,101,103,40,11,3,235,110,53,31,23,13,2,3,990,534,221,235,2335,Census Tract 3,08,107,000300,Routt County
4,1300,1013,178,366,206,186,51,16,10,287,74,103,61,29,9,10,1,1300,797,216,287,3443,Census Tract 4,08,107,000400,Routt County
5,1608,946,162,418,163,137,50,12,4,662,278,214,77,64,22,3,4,1608,678,268,662,3970,Census Tract 5,08,107,000500,Routt County
6,1309,956,197,404,160,140,36,12,7,353,108,127,63,41,11,1,2,1309,746,210,353,3139,Census Tract 6,08,107,000600,Routt County
7,2162,1314,408,597,161,105,27,14,2,848,281,331,137,65,25,7,2,2162,1029,285,848,4595,Census Tract 7,08,107,000700,Routt County
8,826,658,138,310,110,79,14,6,1,168,51,44,28,23,15,5,2,826,486,172,168,1951,Census Tract 8,08,107,000800,Routt County
1,1566,1174,435,494,134,75,23,10,3,392,179,104,51,37,15,4,2,1566,648,526,392,3143,Census Tract 9776,08,109,977600,Saguache County
2,1074,647,139,196,112,88,75,26,11,427,119,115,77,54,45,12,5,1074,365,282,427,2965,Census Tract 9777,08,109,977700,Saguache County
1,344,210,77,91,16,17,6,1,2,134,63,41,11,8,9,1,1,344,121,89,134,699,Census Tract 9726,08,111,972600,San Juan County
1,1052,480,170,166,55,64,22,2,1,572,236,164,98,50,19,3,2,1052,362,118,572,2239,Census Tract 9681.01,08,113,968101,San Miguel County
2,878,301,82,107,45,48,11,7,1,577,389,116,36,24,8,2,2,878,229,72,577,1620,Census Tract 9681.02,08,113,968102,San Miguel County
3,871,682,171,258,127,105,16,1,4,189,73,62,29,19,4,0,2,871,541,141,189,2006,Census Tract 9681.03,08,113,968103,San Miguel County
4,653,498,128,229,69,50,18,2,2,155,47,49,21,23,9,4,2,653,325,173,155,1494,Census Tract 9682,08,113,968200,San Miguel County
1,1093,773,229,340,90,69,35,9,1,320,155,78,36,30,13,7,1,1093,363,410,320,2379,Census Tract 9683,08,115,968300,Sedgwick County
1,3031,2088,477,1009,318,201,58,12,13,943,226,276,140,153,75,43,30,3031,1645,443,943,7406,Census Tract 1,08,117,000100,Summit County
2,2946,1818,458,721,280,249,65,26,19,1128,318,370,191,148,56,29,16,2946,1455,363,1128,7285,Census Tract 2,08,117,000200,Summit County
3,1713,1136,353,528,118,94,34,8,1,577,197,205,100,50,21,0,4,1713,845,291,577,3676,Census Tract 3,08,117,000300,Summit County
4,1800,1008,232,447,135,141,31,15,7,792,228,298,153,66,31,12,4,1800,773,235,792,4254,Census Tract 4.01,08,117,000401,Summit County
5,2264,1522,310,707,232,201,55,13,4,742,223,266,118,89,28,10,8,2264,1206,316,742,5373,Census Tract 4.02,08,117,000402,Summit County
1,2955,2353,384,1100,358,338,103,50,20,602,196,159,107,87,28,15,10,2955,1905,448,602,7468,Census Tract 101.03,08,119,010103,Teller County
2,845,598,146,270,85,68,21,5,3,247,96,66,45,26,10,1,3,845,435,163,247,1915,Census Tract 101.04,08,119,010104,Teller County
3,2522,2226,444,1120,280,241,98,31,12,296,78,101,38,38,17,13,11,2522,1714,512,296,6045,Census Tract 101.05,08,119,010105,Teller County
4,1962,1693,377,825,218,174,63,26,10,269,88,84,38,31,21,7,0,1962,1384,309,269,4643,Census Tract 101.06,08,119,010106,Teller County
5,1210,868,247,433,89,45,35,13,6,342,131,107,48,25,22,5,4,1210,635,233,342,2674,Census Tract 102.01,08,119,010201,Teller County
6,311,202,79,89,18,9,7,0,0,109,46,33,16,10,2,1,1,311,126,76,109,605,Census Tract 102.02,08,119,010202,Teller County
1,881,638,163,290,74,53,32,15,11,243,82,54,33,37,23,11,3,881,297,341,243,2149,Census Tract 9241,08,121,924100,Washington County
2,1099,793,248,319,91,81,34,11,9,306,128,83,40,20,20,10,5,1099,412,381,306,2665,Census Tract 9242,08,121,924200,Washington County
1,1222,121,30,22,25,15,14,7,8,1101,643,226,105,68,38,11,10,1222,89,32,1101,2468,Census Tract 1,08,123,000100,Weld County
2,867,51,14,17,6,5,5,1,3,816,295,283,85,69,49,18,17,867,32,19,816,3207,Census Tract 2,08,123,000200,Weld County
3,1,0,0,0,0,0,0,0,0,1,0,1,0,0,0,0,0,1,0,0,1,1869,Census Tract 3,08,123,000300,Weld County
4,1352,776,234,344,97,70,17,9,5,576,182,183,94,64,30,14,9,1352,528,248,576,3166,Census Tract 4.01,08,123,000401,Weld County
5,1285,490,138,194,70,42,26,11,9,795,247,198,130,100,55,33,32,1285,355,135,795,3362,Census Tract 4.02,08,123,000402,Weld County
6,935,435,75,103,70,67,58,35,27,500,97,97,100,82,65,30,29,935,297,138,500,3128,Census Tract 5.01,08,123,000501,Weld County
7,1160,381,109,106,48,44,26,19,29,779,249,175,120,87,77,38,33,1160,298,83,779,3313,Census Tract 5.02,08,123,000502,Weld County
8,200,96,19,26,22,7,9,7,6,104,29,13,22,16,11,6,7,200,47,49,104,1634,Census Tract 6,08,123,000600,Weld County
9,525,263,71,71,44,23,22,12,20,262,68,57,42,37,32,14,12,525,178,85,262,1602,Census Tract 7.01,08,123,000701,Weld County
10,1892,1252,186,259,192,242,167,104,102,640,82,127,137,101,99,47,47,1892,992,260,640,6796,Census Tract 7.03,08,123,000703,Weld County
11,210,179,20,52,39,40,16,8,4,31,1,10,8,5,5,2,0,210,167,12,31,661,Census Tract 7.04,08,123,000704,Weld County
12,602,397,85,194,54,26,20,9,9,205,57,49,41,27,14,9,8,602,252,145,205,1541,Census Tract 7.05,08,123,000705,Weld County
13,1491,195,69,77,16,11,13,4,5,1296,609,338,133,118,54,24,20,1491,132,63,1296,3401,Census Tract 8,08,123,000800,Weld County
14,1062,711,176,282,102,83,42,11,15,351,59,102,79,53,44,6,8,1062,487,224,351,2806,Census Tract 9,08,123,000900,Weld County
15,1699,529,132,149,71,79,55,26,17,1170,355,267,203,165,102,50,28,1699,308,221,1170,4718,Census Tract 10.03,08,123,001003,Weld County
16,1525,550,127,178,86,63,49,26,21,975,224,254,186,127,100,47,37,1525,406,144,975,4433,Census Tract 10.04,08,123,001004,Weld County
17,2129,1313,221,355,242,262,137,53,43,816,155,235,155,131,72,47,21,2129,1133,180,816,6459,Census Tract 10.05,08,123,001005,Weld County
18,1533,1110,262,335,174,165,94,42,38,423,106,84,80,64,50,23,16,1533,881,229,423,4431,Census Tract 10.06,08,123,001006,Weld County
19,1923,941,216,358,170,121,41,19,16,982,465,221,116,95,55,16,14,1923,696,245,982,4503,Census Tract 11,08,123,001100,Weld County
20,1605,715,210,274,90,71,44,14,12,890,359,219,131,77,66,22,16,1605,489,226,890,3802,Census Tract 12.01,08,123,001201,Weld County
21,1078,807,186,311,141,105,34,16,14,271,110,60,31,27,26,9,8,1078,574,233,271,2785,Census Tract 12.02,08,123,001202,Weld County
22,2219,1294,281,386,221,167,136,51,52,925,288,195,160,117,97,38,30,2219,920,374,925,6458,Census Tract 13,08,123,001300,Weld County
23,930,761,128,316,122,99,62,19,15,169,33,37,24,33,25,9,8,930,573,188,169,2613,Census Tract 14.04,08,123,001404,Weld County
24,1300,954,171,290,184,176,91,29,13,346,66,89,77,56,22,27,9,1300,894,60,346,3781,Census Tract 14.05,08,123,001405,Weld County
25,2077,1471,310,551,226,223,101,35,25,606,199,195,92,71,33,8,8,2077,1308,163,606,5306,Census Tract 14.06,08,123,001406,Weld County
26,617,578,51,196,119,135,46,21,10,39,2,6,5,14,6,4,2,617,497,81,39,1933,Census Tract 14.07,08,123,001407,Weld County
27,765,581,79,301,92,61,25,15,8,184,75,31,31,23,14,8,2,765,405,176,184,2046,Census Tract 14.08,08,123,001408,Weld County
28,1450,649,134,292,95,78,28,13,9,801,289,289,129,70,16,7,1,1450,486,163,801,3267,Census Tract 14.09,08,123,001409,Weld County
29,1379,1251,320,631,144,105,33,13,5,128,61,29,9,13,11,3,2,1379,772,479,128,3005,Census Tract 14.10,08,123,001410,Weld County
30,1028,725,151,305,116,94,34,20,5,303,128,98,40,16,17,3,1,1028,566,159,303,2433,Census Tract 14.11,08,123,001411,Weld County
31,869,653,104,278,102,103,46,14,6,216,84,53,34,23,14,6,2,869,541,112,216,2309,Census Tract 14.12,08,123,001412,Weld County
32,1038,724,169,284,109,92,40,13,17,314,57,77,71,58,32,10,9,1038,527,197,314,2791,Census Tract 14.13,08,123,001413,Weld County
33,784,641,134,246,88,99,49,14,11,143,22,46,15,26,19,11,4,784,530,111,143,2152,Census Tract 14.14,08,123,001414,Weld County
34,1224,1090,136,363,199,242,104,33,13,134,17,19,27,29,26,8,8,1224,956,134,134,3736,Census Tract 14.15,08,123,001415,Weld County
35,788,668,119,301,110,80,40,12,6,120,20,49,26,13,10,2,0,788,557,111,120,1999,Census Tract 14.16,08,123,001416,Weld County
36,775,615,85,216,132,110,37,25,10,160,22,34,37,31,19,11,6,775,495,120,160,2294,Census Tract 14.17,08,123,001417,Weld County
37,2442,1874,324,737,267,335,140,53,18,568,190,145,81,85,37,23,7,2442,1472,402,568,6547,Census Tract 15,08,123,001500,Weld County
38,1544,1175,192,441,204,183,102,38,15,369,93,86,62,55,50,15,8,1544,856,319,369,4346,Census Tract 16,08,123,001600,Weld County
39,1630,1196,211,478,186,166,86,41,28,434,87,109,70,68,60,29,11,1630,861,335,434,4653,Census Tract 17,08,123,001700,Weld County
40,1510,1097,206,411,181,155,86,33,25,413,98,106,65,68,48,23,5,1510,816,281,413,4222,Census Tract 18,08,123,001800,Weld County
41,2398,2026,374,738,338,287,177,68,44,372,56,94,64,69,48,26,15,2398,1711,315,372,7743,Census Tract 19.02,08,123,001902,Weld County
42,1339,934,120,272,133,177,120,57,55,405,128,78,68,49,49,16,17,1339,777,157,405,4322,Census Tract 19.05,08,123,001905,Weld County
43,510,384,71,143,52,52,30,21,15,126,24,36,20,22,13,7,4,510,248,136,126,1502,Census Tract 19.06,08,123,001906,Weld County
44,967,705,101,284,112,104,56,30,18,262,71,61,45,39,33,6,7,967,528,177,262,2775,Census Tract 19.07,08,123,001907,Weld County
45,1015,604,125,203,85,78,65,22,26,411,100,96,81,57,35,21,21,1015,408,196,411,3000,Census Tract 19.08,08,123,001908,Weld County
46,1333,988,225,341,166,134,59,29,34,345,74,79,67,54,37,17,17,1333,768,220,345,3729,Census Tract 20.04,08,123,002004,Weld County
47,180,152,14,51,32,29,14,6,6,28,8,7,5,2,4,1,1,180,134,18,28,561,Census Tract 20.05,08,123,002005,Weld County
48,124,103,20,45,11,15,4,4,4,21,4,5,5,3,4,0,0,124,73,30,21,339,Census Tract 20.06,08,123,002006,Weld County
49,1819,1541,200,565,310,283,127,38,18,278,78,88,39,39,26,5,3,1819,1369,172,278,5110,Census Tract 20.07,08,123,002007,Weld County
50,1661,1421,243,486,240,309,105,28,10,240,48,64,52,47,19,6,4,1661,1312,109,240,4621,Census Tract 20.08,08,123,002008,Weld County
51,495,442,60,210,64,63,29,9,7,53,13,16,7,5,7,4,1,495,330,112,53,1332,Census Tract 20.09,08,123,002009,Weld County
52,732,626,147,203,115,87,45,17,12,106,19,38,18,13,11,4,3,732,438,188,106,1964,Census Tract 20.10,08,123,002010,Weld County
53,127,118,21,48,16,24,7,1,1,9,4,1,1,2,0,0,1,127,107,11,9,334,Census Tract 20.11,08,123,002011,Weld County
54,273,260,15,95,46,54,30,12,8,13,1,3,1,5,1,2,0,273,249,11,13,892,Census Tract 20.12,08,123,002012,Weld County
55,911,817,102,264,152,201,57,26,15,94,13,24,12,20,16,6,3,911,772,45,94,2760,Census Tract 20.13,08,123,002013,Weld County
56,595,478,134,192,63,58,17,7,7,117,26,30,26,15,14,1,5,595,354,124,117,1455,Census Tract 20.14,08,123,002014,Weld County
57,383,338,46,105,75,71,29,9,3,45,4,15,5,8,7,3,3,383,324,14,45,1148,Census Tract 20.15,08,123,002015,Weld County
58,1042,853,160,266,165,137,75,21,29,189,38,52,29,39,20,4,7,1042,741,112,189,3023,Census Tract 20.16,08,123,002016,Weld County
59,206,197,13,94,20,46,19,1,4,9,4,2,2,0,0,0,1,206,174,23,9,600,Census Tract 20.17,08,123,002017,Weld County
60,294,252,20,103,54,42,15,11,7,42,4,12,7,8,6,5,0,294,233,19,42,893,Census Tract 20.18,08,123,002018,Weld County
61,1156,971,138,331,172,181,98,33,18,185,48,38,34,33,17,7,8,1156,858,113,185,3413,Census Tract 20.19,08,123,002019,Weld County
62,1519,1393,112,432,240,370,151,56,32,126,8,22,21,36,22,9,8,1519,1328,65,126,4990,Census Tract 20.20,08,123,002020,Weld County
63,237,218,42,94,30,34,9,2,7,19,2,8,4,2,0,2,1,237,175,43,19,622,Census Tract 20.21,08,123,002021,Weld County
64,2441,1899,273,651,331,353,166,83,42,542,85,138,110,106,63,28,12,2441,1692,207,542,7319,Census Tract 21.01,08,123,002101,Weld County
65,3388,2850,365,1092,476,541,243,87,46,538,97,110,95,114,73,32,17,3388,2465,385,538,9989,Census Tract 21.02,08,123,002102,Weld County
66,2873,2550,367,1032,406,446,184,71,44,323,69,111,54,49,27,5,8,2873,2064,486,323,8009,Census Tract 21.03,08,123,002103,Weld County
67,324,264,28,115,42,41,30,4,4,60,22,19,5,9,3,2,0,324,216,48,60,893,Census Tract 22.03,08,123,002203,Weld County
68,746,592,105,223,78,122,43,17,4,154,42,49,22,23,15,2,1,746,521,71,154,2013,Census Tract 22.04,08,123,002204,Weld County
69,1754,1200,232,423,214,206,93,23,9,554,200,152,90,66,34,9,3,1754,1034,166,554,4605,Census Tract 22.05,08,123,002205,Weld County
70,1318,1004,158,353,175,186,90,27,15,314,128,76,41,34,27,5,3,1318,829,175,314,3582,Census Tract 22.06,08,123,002206,Weld County
71,662,551,79,197,96,109,51,13,6,111,19,17,29,32,8,6,0,662,479,72,111,1918,Census Tract 22.07,08,123,002207,Weld County
72,1649,1431,157,590,278,257,102,32,15,218,61,56,40,40,11,9,1,1649,1225,206,218,4588,Census Tract 22.08,08,123,002208,Weld County
73,365,261,29,126,38,48,19,1,0,104,46,32,7,11,7,1,0,365,218,43,104,904,Census Tract 22.09,08,123,002209,Weld County
74,249,222,16,79,38,52,22,12,3,27,5,6,6,6,2,1,1,249,193,29,27,783,Census Tract 22.10,08,123,002210,Weld County
75,1725,1219,240,496,186,144,98,40,15,506,151,114,87,63,53,22,16,1725,929,290,506,4619,Census Tract 23,08,123,002300,Weld County
76,1862,1475,304,605,223,199,88,27,29,387,132,86,59,50,35,17,8,1862,1091,384,387,4843,Census Tract 25.01,08,123,002501,Weld County
77,2012,1482,257,586,205,231,121,47,35,530,168,85,103,75,57,21,21,2012,1124,358,530,5656,Census Tract 25.02,08,123,002502,Weld County
1,1799,1220,288,519,148,141,78,36,10,579,220,128,86,73,34,27,11,1799,649,571,579,4602,Census Tract 9631,08,125,963100,Yuma County
2,2153,1468,363,588,175,210,84,34,14,685,249,142,111,88,57,25,13,2153,858,610,685,5441,Census Tract 9632,08,125,963200,Yuma County
